date,state,positive,negative,pending,hospitalizedCurrently,hospitalizedCumulative,inIcuCurrently,inIcuCumulative,onVentilatorCurrently,onVentilatorCumulative,recovered,dataQualityGrade,lastUpdateEt,dateModified,checkTimeEt,death,hospitalized,dateChecked,totalTestsViral,positiveTestsViral,negativeTestsViral,positiveCasesViral,fips,positiveIncrease,negativeIncrease,total,totalTestResults,totalTestResultsIncrease,posNeg,deathIncrease,hospitalizedIncrease,hash,commercialScore,negativeRegularScore,negativeScore,positiveScore,score,grade
20200626,WA,30367,475428,,272,4106,,,49,,,B,6/25/2020 02:59,2020-06-25T02:59:00Z,06/24 22:59,1300,4106,2020-06-25T02:59:00Z,,,,30367,53,498,9799,505795,505795,10297,505795,7,13,734676275734c3dcc8cb4d362a1f18912df8958d,0,0,0,0,0,
20200625,WA,29869,465629,,304,4093,,,56,,,B,6/24/2020 02:59,2020-06-24T02:59:00Z,06/23 22:59,1293,4093,2020-06-24T02:59:00Z,,,,29869,53,483,7956,495498,495498,8439,495498,9,26,ac56d1065a53d4c8519f14095da39b4ed67fcc26,0,0,0,0,0,
20200624,WA,29386,457673,,234,4067,,,44,,,B,6/23/2020 02:59,2020-06-23T02:59:00Z,06/22 22:59,1284,4067,2020-06-23T02:59:00Z,,,,29386,53,516,9339,487059,487059,9855,487059,8,5,9afe496906346841fa920cb79d389e6380793ef6,0,0,0,0,0,
20200623,WA,28870,448334,,204,4062,,,37,,,B,6/22/2020 02:59,2020-06-22T02:59:00Z,06/21 22:59,1276,4062,2020-06-22T02:59:00Z,,,,28870,53,190,2076,477204,477204,2266,477204,6,13,9e33299f348a29d1d224ec3886ba87b11ec7d185,0,0,0,0,0,
20200622,WA,28680,446258,,205,4049,,,42,,,B,6/22/2020 02:59,2020-06-22T02:59:00Z,06/21 22:59,1270,4049,2020-06-22T02:59:00Z,,,,28680,53,425,8414,474938,474938,8839,474938,5,19,65a93f647c9b55c974679fa9d19dd8ae2daac654,0,0,0,0,0,
20200621,WA,28255,437844,,267,4030,,,54,,,B,6/21/2020 02:59,2020-06-21T02:59:00Z,06/20 22:59,1265,4030,2020-06-21T02:59:00Z,,,,28255,53,-425,-8627,466099,466099,-9052,466099,10,27,dbfef099c6a9d0e35697b01a8acefd5278a6402f,0,0,0,0,0,
20200620,WA,28680,446471,,245,4003,,,49,,,B,6/20/2020 02:59,2020-06-20T02:59:00Z,06/19 22:59,1255,4003,2020-06-20T02:59:00Z,,,,28658,53,14,675,475151,475151,689,475151,10,44,406189a26ec492cfb3dd89d4f7b771cb8cd6d57a,0,0,0,0,0,
20200619,WA,28666,445796,,276,3959,,,47,,,B,6/18/2020 02:59,2020-06-18T02:59:00Z,06/17 22:59,1245,3959,2020-06-18T02:59:00Z,,,,28644,53,91,4328,474462,474462,4419,474462,19,21,b109536b7b2b1b07fa169ef721d85c188ada1656,0,0,0,0,0,
20200618,WA,28575,441468,,263,3938,,,47,,,B,6/17/2020 02:59,2020-06-17T02:59:00Z,06/16 22:59,1226,3938,2020-06-17T02:59:00Z,,,,28556,53,320,6299,470043,470043,6619,470043,-5,23,ad90390bb1ba3c90fed9d2823cfc360ce4a34bc7,0,0,0,0,0,
20200617,WA,28255,435169,,256,3915,,,47,,,B,6/16/2020 02:59,2020-06-16T02:59:00Z,06/15 22:59,1231,3915,2020-06-16T02:59:00Z,,,,28233,53,330,8583,463424,463424,8913,463424,10,21,e765327fe5019bee9ec7a8497563db5c515f20ed,0,0,0,0,0,
20200616,WA,27925,426586,,235,3894,,,38,,,B,6/15/2020 02:59,2020-06-15T02:59:00Z,06/14 22:59,1221,3894,2020-06-15T02:59:00Z,,,,27876,53,432,10510,454511,454511,10942,454511,4,38,334820008dbf7d3ace9814edec142eaff9a7562c,0,0,0,0,0,
20200615,WA,27493,416076,,197,3856,,,41,,,B,6/14/2020 02:59,2020-06-14T02:59:00Z,06/13 22:59,1217,3856,2020-06-14T02:59:00Z,,,,27407,53,398,10277,443569,443569,10675,443569,4,11,bceba5afd6d835a35fa29e4a258919fa0cc019b9,0,0,0,0,0,
20200614,WA,27095,405799,,229,3845,,,49,,,B,6/13/2020 02:59,2020-06-13T02:59:00Z,06/12 22:59,1213,3845,2020-06-13T02:59:00Z,,,,26934,53,110,3650,432894,432894,3760,432894,9,28,504797382c6f6a71acdb61b14d427d34b294bfb7,0,0,0,0,0,
20200613,WA,26985,402149,,225,3817,,,43,,,B,6/12/2020 02:59,2020-06-12T02:59:00Z,06/11 22:59,1204,3817,2020-06-12T02:59:00Z,,,,26805,53,160,5929,429134,429134,6089,429134,10,45,907a312a09e72fd972f740208f88710ef0672787,0,0,0,0,0,
20200612,WA,26825,396220,,226,3772,,,8,,,B,6/12/2020 02:59,2020-06-12T02:59:00Z,06/11 22:59,1194,3772,2020-06-12T02:59:00Z,,,,26619,53,266,8925,423045,423045,9191,423045,4,-1,0a68553d396a27df66cda5b9d33940569377efbb,0,0,0,0,0,
20200611,WA,26559,387295,,226,3773,,,63,,,B,6/11/2020 02:59,2020-06-11T02:59:00Z,06/10 22:59,1190,3773,2020-06-11T02:59:00Z,,,,26269,53,278,10931,413854,413854,11209,413854,14,26,3211090be08024575829b780f27f81e6d99770d0,0,0,0,0,0,
20200610,WA,26281,376364,,238,3747,,,92,,,B,6/10/2020 02:59,2020-06-10T02:59:00Z,06/09 22:59,1176,3747,2020-06-10T02:59:00Z,,,,25901,53,277,11278,402645,402645,11555,402645,15,48,da569a7f2a49d1ff7f3be269fb3f2443991c08f3,0,0,0,0,0,
20200609,WA,26004,365086,,205,3699,,,60,,,B,6/8/2020 02:59,2020-06-08T02:59:00Z,06/07 22:59,1161,3699,2020-06-08T02:59:00Z,,,,25580,53,272,9513,391090,391090,9785,391090,2,30,986b6cf0b9c5e1de1a71abaaab35bbe7d15d64c4,0,0,0,0,0,
20200608,WA,25732,355573,,213,3669,,,66,,,B,6/7/2020 02:59,2020-06-07T02:59:00Z,06/06 22:59,1159,3669,2020-06-07T02:59:00Z,,,,25203,53,313,7963,381305,381305,8276,381305,6,17,e9cd6860e4a0947d48988b96a26cf8e85e686636,0,0,0,0,0,
20200607,WA,25419,347610,,205,3652,,,57,,,B,6/6/2020 02:59,2020-06-06T02:59:00Z,06/05 22:59,1153,3652,2020-06-06T02:59:00Z,,,,24739,53,192,2180,373029,373029,2372,373029,4,13,6f40a9a5924f229f07ef49824b22973309fbef5b,0,0,0,0,0,
20200606,WA,25227,345430,,247,3639,,,86,,,B,6/6/2020 02:59,2020-06-06T02:59:00Z,06/05 22:59,1149,3639,2020-06-06T02:59:00Z,,,,24635,53,204,3545,370657,370657,3749,370657,11,24,d049f239a3660315b2eda321361d5ca5106fe3d4,0,0,0,0,0,
20200605,WA,25023,341885,,285,3615,,,91,,,B,6/5/2020 00:00,2020-06-05T00:00:00Z,06/04 20:00,1138,3615,2020-06-05T00:00:00Z,,,,24482,53,346,5913,366908,366908,6259,366908,3,37,4b60384878951a8fe093b6e94054da9fb50f6815,0,0,0,0,0,
20200604,WA,24677,335972,,272,3578,,,94,,,B,6/4/2020 02:59,2020-06-04T02:59:00Z,06/03 22:59,1135,3578,2020-06-04T02:59:00Z,,,,24124,53,292,4297,360649,360649,4589,360649,6,35,c753eb4069e4aa263f43218acb8f17fc0ee44981,0,0,0,0,0,
20200603,WA,24385,331675,,263,3543,,,89,,,B,6/3/2020 00:00,2020-06-03T00:00:00Z,06/02 20:00,1129,3543,2020-06-03T00:00:00Z,,,,23812,53,299,5029,356060,356060,5328,356060,5,26,aeb7fac0fd7c48bb4a0ec763941fcbc1fe4a577f,0,0,0,0,0,
20200602,WA,24086,326646,,232,3517,,,48,,,B,6/2/2020 00:00,2020-06-02T00:00:00Z,06/01 20:00,1124,3517,2020-06-02T00:00:00Z,,,,23463,53,288,6119,350732,350732,6407,350732,6,16,7c37d8a5de6891190e3d0c170d82935fd337789c,0,0,0,0,0,
20200601,WA,23798,320527,,245,3501,,,52,,,B,6/1/2020 00:00,2020-06-01T00:00:00Z,05/31 20:00,1118,3501,2020-06-01T00:00:00Z,,,,23069,53,342,5856,344325,344325,6198,344325,0,21,1c2c91fee241ea5feb1b8436a515dd76a5ca5a5f,0,0,0,0,0,
20200531,WA,23456,314671,,266,3480,,,67,,,B,5/31/2020 02:59,2020-05-31T02:59:00Z,05/30 22:59,1118,3480,2020-05-31T02:59:00Z,,,,22683,53,181,2163,338127,338127,2344,338127,7,25,3d39533c0da00b2873e187b27683c4f2efb4ecd9,0,0,0,0,0,
20200530,WA,23275,312508,,319,3455,,,88,,,B,5/30/2020 02:59,2020-05-30T02:59:00Z,05/29 22:59,1111,3455,2020-05-30T02:59:00Z,,,,22583,53,228,3070,335783,335783,3298,335783,5,42,bb673feb0b8116fedf84dd6922c303dee1da233c,0,0,0,0,0,
20200529,WA,23047,309438,,317,3413,,,85,,,B,5/29/2020 02:59,2020-05-29T02:59:00Z,05/28 22:59,1106,3413,2020-05-29T02:59:00Z,,,,22435,53,294,5098,332485,332485,5392,332485,11,19,037727c19dd2f08acc8528bd5725a85fa2651122,0,0,0,0,0,
20200528,WA,22753,304340,,325,3394,,,94,,,B,5/27/2020 02:59,2020-05-27T02:59:00Z,05/26 22:59,1095,3394,2020-05-27T02:59:00Z,,,,22107,53,270,4962,327093,327093,5232,327093,17,56,b79338f3a25d43dc051158eaa45ca4a26aabc24a,0,0,0,0,0,
20200527,WA,22483,299378,,241,3338,,,53,,,B,5/26/2020 02:59,2020-05-26T02:59:00Z,05/25 22:59,1078,3338,2020-05-26T02:59:00Z,,,,21820,53,299,5444,321861,321861,5743,321861,8,48,a89d40e86c1020ae02e3f47f89bb6fb619e97839,0,0,0,0,0,
20200526,WA,22184,293934,,267,3290,,,51,,,B,5/25/2020 02:59,2020-05-25T02:59:00Z,05/24 22:59,1070,3290,2020-05-25T02:59:00Z,,,,21479,53,275,6620,316118,316118,6895,316118,9,3,08dc5b609a6f1234cb2bb55b3c9877e0ce78fd59,0,0,0,0,0,
20200525,WA,21909,287314,,207,3287,,,47,,,B,5/24/2020 02:59,2020-05-24T02:59:00Z,05/23 22:59,1061,3287,2020-05-24T02:59:00Z,,,,21101,53,257,2226,309223,309223,2483,309223,6,31,4b57fabba5b7642e25229212555f908dcef3206e,0,0,0,0,0,
20200524,WA,21652,285088,,313,3256,,,74,,,B,5/23/2020 02:59,2020-05-23T02:59:00Z,05/22 22:59,1055,3256,2020-05-23T02:59:00Z,,,,20956,53,160,2182,306740,306740,2342,306740,5,26,258285d3c8a021d4c78bf1a7f5629268d1cdbcf7,0,0,0,0,0,
20200523,WA,21492,282906,,332,3230,,,96,,,B,5/22/2020 02:59,2020-05-22T02:59:00Z,05/21 22:59,1050,3230,2020-05-22T02:59:00Z,,,,20858,53,209,2462,304398,304398,2671,304398,6,74,5de3ff34c9ccd106764b0240b157421598d9001b,0,0,0,0,0,
20200522,WA,21283,280444,,332,3156,,,85,,,B,5/21/2020 02:59,2020-05-21T02:59:00Z,05/20 22:59,1044,3156,2020-05-21T02:59:00Z,,,,20711,53,295,4273,301727,301727,4568,301727,7,31,3a6ecc95220b3250c2da85aec01431d20bcaf963,0,0,0,0,0,
20200521,WA,20988,276171,,242,3125,,,70,,,B,5/20/2020 02:59,2020-05-20T02:59:00Z,05/19 22:59,1037,3125,2020-05-20T02:59:00Z,,,,20403,53,204,4468,297159,297159,4672,297159,6,3125,4538e5d5602ca7be6eddb53bd5afbe7ac6e085ca,0,0,0,0,0,
20200520,WA,20784,271703,,168,,52,,,,,B,5/19/2020 02:59,2020-05-19T02:59:00Z,05/18 22:59,1031,,2020-05-19T02:59:00Z,,,,20112,53,249,5389,292487,292487,5638,292487,29,0,3dc1d3f206e6ef5609d27787007aa2771b3eb0f3,0,0,0,0,0,
20200519,WA,20535,266314,,168,,52,,,,,A,5/18/2020 02:59,2020-05-18T02:59:00Z,05/17 22:59,1002,,2020-05-18T02:59:00Z,,,,19871,53,249,6847,286849,286849,7096,286849,1,0,81481b9078641f3e7f13fb7f5de9dc587c443fa8,0,0,0,0,0,
20200518,WA,20286,259467,,168,,52,,,,,A,5/17/2020 02:59,2020-05-17T02:59:00Z,05/16 22:59,1001,,2020-05-17T02:59:00Z,,,,19581,53,295,6687,279753,279753,6982,279753,1,0,8a15cceea626322a73a4476a8ec3535c2e35ac4a,0,0,0,0,0,
20200517,WA,19991,252780,,168,,52,,,,,A,5/17/2020 00:00,2020-05-17T00:00:00Z,05/16 20:00,1000,,2020-05-17T00:00:00Z,,,,19265,53,153,1817,272771,272771,1970,272771,8,0,af1b122a3b722ad6c91322a664f1e50f26ee5979,0,0,0,0,0,
20200516,WA,19838,250963,,331,,90,,,,,A,5/16/2020 00:00,2020-05-16T00:00:00Z,05/15 20:00,992,,2020-05-16T00:00:00Z,,,,19202,53,188,2641,270801,270801,2829,270801,9,0,b2056c525233444745da8650985934e66e68f6ec,0,0,0,0,0,
20200515,WA,19650,248322,,374,,114,,,,,A,5/15/2020 00:00,2020-05-15T00:00:00Z,05/14 20:00,983,,2020-05-15T00:00:00Z,,,,19082,53,226,5178,267972,267972,5404,267972,8,0,4770e766e3544ea2deb3c048efc1b5150fac45b2,0,0,0,0,0,
20200514,WA,19424,243144,,365,,111,,,,,A,5/14/2020 00:00,2020-05-14T00:00:00Z,05/13 20:00,975,,2020-05-14T00:00:00Z,,,,18823,53,245,4760,262568,262568,5005,262568,13,0,d56a501325f466733b4786941b5a8ce0e81ff264,0,0,0,0,0,
20200513,WA,19179,238384,,384,,114,,,,,A,5/13/2020 00:00,2020-05-13T00:00:00Z,05/12 20:00,962,,2020-05-13T00:00:00Z,,,,18554,53,227,4520,257563,257563,4747,257563,17,0,7ca5b94cba5678034859152be653b8bb5a76327f,0,0,0,0,0,
20200512,WA,18952,233864,,321,,94,,,,,A,5/12/2020 00:00,2020-05-12T00:00:00Z,05/11 20:00,945,,2020-05-12T00:00:00Z,,,,18249,53,211,4765,252816,252816,4976,252816,14,0,a6d6704de294d1c164c389cece5f3e7722784939,0,0,0,0,0,
20200511,WA,18741,229099,,350,,110,,,,,B,5/11/2020 00:00,2020-05-11T00:00:00Z,05/10 20:00,931,,2020-05-11T00:00:00Z,,,,18001,53,292,4551,247840,247840,4843,247840,10,0,840142d0a5a7062060f7a413027eb64a30889d39,0,0,0,0,0,
20200510,WA,18449,224548,,335,,101,,,,,B,5/10/2020 00:00,2020-05-10T00:00:00Z,05/09 20:00,921,,2020-05-10T00:00:00Z,,,,17705,53,174,1187,242997,242997,1361,242997,16,0,59ff6756197034ea1abc042ee7db7ab05b002b6c,0,0,0,0,0,
20200509,WA,18275,223361,,393,,128,,,,,B,5/9/2020 00:00,2020-05-09T00:00:00Z,05/08 20:00,905,,2020-05-09T00:00:00Z,,,,17645,53,151,1943,241636,241636,2094,241636,14,0,ba580d196d9200d8f68b56fddfd21dd9336f80b1,0,0,0,0,0,
20200508,WA,18124,221418,,393,,122,,,,,B,5/8/2020 00:00,2020-05-08T00:00:00Z,05/07 20:00,891,,2020-05-08T00:00:00Z,,,,17519,53,210,4965,239542,239542,5175,239542,21,0,a1c41dd721c26693dde81406255075d55ffabc74,0,0,0,0,0,
20200507,WA,17914,216453,,358,,144,,,,,B,5/7/2020 00:00,2020-05-07T00:00:00Z,05/06 20:00,870,,2020-05-07T00:00:00Z,,,,17269,53,196,4388,234367,234367,4584,234367,8,0,ae397fefc00840771c6ba516edfe722b76e22198,0,0,0,0,0,
20200506,WA,17718,212065,,390,,127,,,,,B,5/6/2020 00:00,2020-05-06T00:00:00Z,05/05 20:00,862,,2020-05-06T00:00:00Z,,,,17012,53,248,5051,229783,229783,5299,229783,21,0,497d808ba5441398487cf2f206cbcfc11132c4c6,0,0,0,0,0,
20200505,WA,17470,207014,,292,,102,,,,,B,5/5/2020 00:00,2020-05-05T00:00:00Z,05/04 20:00,841,,2020-05-05T00:00:00Z,,,,16726,53,261,4808,224484,224484,5069,224484,7,0,c2e1b1493d5aa4ef9ed7643445be97c6e45ee378,0,0,0,0,0,
20200504,WA,17209,202206,,263,,86,,,,,B,5/4/2020 00:00,2020-05-04T00:00:00Z,05/03 20:00,834,,2020-05-04T00:00:00Z,,,,16472,53,266,5244,219415,219415,5510,219415,4,0,9f6f0a06316e8e06fe1d95ae2b376884be10c2c1,0,0,0,0,0,
20200503,WA,16943,196962,,411,,120,,,,,B,5/3/2020 00:00,2020-05-03T00:00:00Z,05/02 20:00,830,,2020-05-03T00:00:00Z,,,,16093,53,141,1343,213905,213905,1484,213905,6,0,8c576ab7a7ac27ff7fa308909bb0a342eb2596ec,0,0,0,0,0,
20200502,WA,16802,195619,,428,,117,,,,,B,5/2/2020 00:00,2020-05-02T00:00:00Z,05/01 20:00,824,,2020-05-02T00:00:00Z,,,,16011,53,149,2170,212421,212421,2319,212421,10,0,502ec2f8f8d89490a2f41f156e0b61b9121c52bd,0,0,0,0,0,
20200501,WA,16653,193449,,470,,120,,,,,B,5/1/2020 00:00,2020-05-01T00:00:00Z,04/30 20:00,814,,2020-05-01T00:00:00Z,,,,15899,53,344,4448,210102,210102,4792,210102,13,0,1fbb540614b79895967883ade68e74377ffd46fd,0,0,0,0,0,
20200430,WA,16309,189001,,474,,145,,,,,B,4/30/2020 00:00,2020-04-30T00:00:00Z,04/29 20:00,801,,2020-04-30T00:00:00Z,,,,15589,53,267,4615,205310,205310,4882,205310,15,0,bae2b76328601a0e429878769a805d85c51c8057,0,0,0,0,0,
20200429,WA,16042,184386,,490,,156,,,,,B,4/29/2020 00:00,2020-04-29T00:00:00Z,04/28 20:00,786,,2020-04-29T00:00:00Z,,,,15343,53,244,4679,200428,200428,4923,200428,21,0,a9948aa1da6dbfee0137d0ce4df3b1a2f8de9d54,0,0,0,0,0,
20200428,WA,15798,179707,,436,,158,,,,,B,4/28/2020 00:00,2020-04-28T00:00:00Z,04/27 20:00,765,,2020-04-28T00:00:00Z,,,,15014,53,232,5115,195505,195505,5347,195505,16,0,9ad13914b728ce127664f2811d6adebb6c752f78,0,0,0,0,0,
20200427,WA,15566,174592,,536,,115,,,,,B,4/27/2020 00:00,2020-04-27T00:00:00Z,04/26 20:00,749,,2020-04-27T00:00:00Z,,,,14723,53,274,4843,190158,190158,5117,190158,11,0,75166c2c0cf1b250d28d7fc049238f4fae6d1f52,0,0,0,0,0,
20200426,WA,15292,169749,,508,,145,,,,,B,4/26/2020 00:00,2020-04-26T00:00:00Z,04/25 20:00,738,,2020-04-26T00:00:00Z,,,,14354,53,182,1596,185041,185041,1778,185041,73,0,ca18a716f5ad892cf126a52477dff43e6e513bff,0,0,0,0,0,
20200425,WA,15110,168153,,455,,174,,,,,B,4/25/2020 00:00,2020-04-25T00:00:00Z,04/24 20:00,665,,2020-04-25T00:00:00Z,,,,14243,53,197,2814,183263,183263,3011,183263,6,0,1ebf6584bdff4b3dcd854e06fbebfe9c8aaf0464,0,0,0,0,0,
20200424,WA,14913,165339,,551,,164,,,,,C,4/24/2020 00:00,2020-04-24T00:00:00Z,04/23 20:00,659,,2020-04-24T00:00:00Z,,,,14076,53,285,5224,180252,180252,5509,180252,5,0,f35066f83a86bbaf07fde57a0f85e195b9258569,0,0,0,0,0,
20200423,WA,14628,160115,,544,,151,,,,,C,4/23/2020 00:00,2020-04-23T00:00:00Z,04/22 20:00,654,,2020-04-23T00:00:00Z,,,,13726,53,253,4085,174743,174743,4338,174743,7,0,95dbaada188f35e19ea878b70c9db645b3c6c666,0,0,0,0,0,
20200422,WA,14375,156030,,543,,161,,,,,C,4/22/2020 00:00,2020-04-22T00:00:00Z,04/21 20:00,647,,2020-04-22T00:00:00Z,,,,13452,53,242,4182,170405,170405,4424,170405,7,0,490c7a74bcdf0a15dd5bd0f1233017deac9c4396,0,0,0,0,0,
20200421,WA,14133,151848,,503,,161,,,,,C,4/21/2020 00:00,2020-04-21T00:00:00Z,04/20 20:00,640,,2020-04-21T00:00:00Z,,,,13170,53,243,3959,165981,165981,4202,165981,11,0,17ebcdbeebcbf8c9e1bdfb5950f1d5c07796ecd7,0,0,0,0,0,
20200420,WA,13890,147889,,403,,122,,,,,C,4/20/2020 00:00,2020-04-20T00:00:00Z,04/19 20:00,629,,2020-04-20T00:00:00Z,,,,12901,53,307,4081,161779,161779,4388,161779,14,0,f6b253ada1eb3e1cc2633ee29e9d2724db670d20,0,0,0,0,0,
20200419,WA,13583,143808,,586,,193,,,,,C,4/19/2020 00:00,2020-04-19T00:00:00Z,04/18 20:00,615,,2020-04-19T00:00:00Z,,,,12567,53,176,1501,157391,157391,1677,157391,17,0,a36b4594a303468a184a77088a3487c161553a70,0,0,0,0,0,
20200418,WA,13407,142307,,518,,155,,,,,C,4/18/2020 00:00,2020-04-18T00:00:00Z,04/17 20:00,598,,2020-04-18T00:00:00Z,,,,12471,53,233,2013,155714,155714,2246,155714,13,0,d27be95b528884371779846d327f174f04fcafbc,0,0,0,0,0,
20200417,WA,13174,140294,,622,,195,,,,,C,4/17/2020 00:00,2020-04-17T00:00:00Z,04/16 20:00,585,,2020-04-17T00:00:00Z,,,,12297,53,302,4150,153468,153468,4452,153468,14,0,a901f3d4916599bb28cb3036103b0e8da7e46153,0,0,0,0,0,
20200416,WA,12872,136144,,595,,196,,,,,C,4/16/2020 00:00,2020-04-16T00:00:00Z,04/15 20:00,571,,2020-04-16T00:00:00Z,,,,11950,53,253,4095,149016,149016,4348,149016,20,0,4943206abd22de0a4b910232225c93fd5bdaf5eb,0,0,0,0,0,
20200415,WA,12619,132049,,645,,194,,,,,C,4/15/2020 00:00,2020-04-15T00:00:00Z,04/14 20:00,551,,2020-04-15T00:00:00Z,,,,11640,53,316,3830,144668,144668,4146,144668,9,0,d598ec34014badb0d9c0126900b78db19aec018b,0,0,0,0,0,
20200414,WA,12303,128219,,387,,98,,,,,C,4/14/2020 00:00,2020-04-14T00:00:00Z,04/13 20:00,542,,2020-04-14T00:00:00Z,,,,11310,53,224,4085,140522,140522,4309,140522,16,0,b420ca84b77abd4275ab6fb281a17a4d1f6f065b,0,0,0,0,0,
20200413,WA,12079,124134,,527,,166,,,,,C,4/13/2020 00:00,2020-04-13T00:00:00Z,04/12 20:00,526,,2020-04-13T00:00:00Z,,,,11011,53,304,3916,136213,136213,4220,136213,17,0,f9a8b63c82310111c591775f0c6ba129d5d12db9,0,0,0,0,0,
20200412,WA,11775,120218,,642,,191,,,,,C,4/12/2020 00:00,2020-04-12T00:00:00Z,04/11 20:00,509,,2020-04-12T00:00:00Z,,,,10643,53,170,1261,131993,131993,1431,131993,15,0,43e01f6c515d4637ed5208719fc625cde526a703,0,0,0,0,0,
20200411,WA,11605,118957,,649,,191,,,,,C,4/11/2020 00:00,2020-04-11T00:00:00Z,04/10 20:00,494,,2020-04-11T00:00:00Z,,,,10554,53,210,1866,130562,130562,2076,130562,18,0,01bf6658ab391fba4dfa78a6daafaa68702d8774,0,0,0,0,0,
20200410,WA,11395,117091,,642,,191,,,,,C,4/10/2020 00:00,2020-04-10T00:00:00Z,04/09 20:00,476,,2020-04-10T00:00:00Z,,,,10399,53,277,4022,128486,128486,4299,128486,17,0,6e5048e78f413a77955a1be405893211263d4a6e,0,0,0,0,0,
20200409,WA,11118,113069,,650,,191,,,,,A,4/9/2020 00:00,2020-04-09T00:00:00Z,04/08 20:00,459,,2020-04-09T00:00:00Z,,,,10092,53,287,4019,124187,124187,4306,124187,16,0,d719d85a7f451fa0258268f5bb800db235f58364,0,0,0,0,0,
20200408,WA,10831,109050,,655,,186,,,,,A,4/8/2020 00:00,2020-04-08T00:00:00Z,04/07 20:00,443,,2020-04-08T00:00:00Z,,,,9728,53,284,4520,119881,119881,4804,119881,14,0,da4f3211ff895b95cfc1775302e7e23045ac6111,0,0,0,0,0,
20200407,WA,10547,104530,,641,,190,,,,,A,4/7/2020 00:00,2020-04-07T00:00:00Z,04/06 20:00,429,,2020-04-07T00:00:00Z,,,,9384,53,265,4964,115077,115077,5229,115077,22,0,d7cbe36ed4eb7c89f1630e21c00062085b4b8ae4,0,0,0,0,0,
20200406,WA,10282,99566,,638,,191,,,,,A,4/6/2020 00:00,2020-04-06T00:00:00Z,04/05 20:00,407,,2020-04-06T00:00:00Z,,,,8971,53,329,4807,109848,109848,5136,109848,21,0,a3d67d16a5a12a85d9f30bdb4f23275d70741dff,0,0,0,0,0,
20200405,WA,9953,94759,,581,,178,,,,,A,4/5/2020 00:00,2020-04-05T00:00:00Z,04/04 20:00,386,,2020-04-05T00:00:00Z,,,,8576,53,221,1731,104712,104712,1952,104712,21,0,74ab2b2ed7423e518ae00beff315052919b1b1e1,0,0,0,0,0,
20200404,WA,9732,93028,,574,,174,,,,,A,4/4/2020 00:00,2020-04-04T00:00:00Z,04/03 20:00,365,,2020-04-04T00:00:00Z,,,,8406,53,247,2367,102760,102760,2614,102760,27,0,c69aabdf5faa916016b3b10ce1c05b73bc2d9c6c,0,0,0,0,0,
20200403,WA,9485,90661,,,,,,,,,A,4/3/2020 00:00,2020-04-03T00:00:00Z,04/02 20:00,338,,2020-04-03T00:00:00Z,,,,8198,53,284,4570,100146,100146,4854,100146,28,0,74a64cf81ccd49bcefb6db3d629400690c86c121,0,0,0,0,0,
20200402,WA,9201,86091,,,,,,,,,A,4/2/2020 00:00,2020-04-02T00:00:00Z,04/01 20:00,310,,2020-04-02T00:00:00Z,,,,7784,53,332,4575,95292,95292,4907,95292,28,0,4d98c99977aa1cdee9924c83d8c9678f96a23f46,0,0,0,0,0,
20200401,WA,8869,81516,,,,,,,,,A,4/1/2020 00:00,2020-04-01T00:00:00Z,03/31 20:00,282,,2020-04-01T00:00:00Z,,,,7381,53,438,4279,90385,90385,4717,90385,20,0,f41d73ef8f8c58fcd10b267b2db2bb4e7a3b5144,0,0,0,0,0,
20200331,WA,8431,77237,,,,,,,,,A,3/31/2020 00:00,2020-03-31T00:00:00Z,03/30 20:00,262,,2020-03-31T00:00:00Z,,,,6933,53,311,4395,85668,85668,4706,85668,14,0,f13efbc07b3abb72e90c85c67e9c4ad1fe77abae,0,0,0,0,0,
20200330,WA,8120,72842,,,,,,,,,A,3/30/2020 00:00,2020-03-30T00:00:00Z,03/29 20:00,248,,2020-03-30T00:00:00Z,,,,6464,53,405,4745,80962,80962,5150,80962,11,0,23835c0f17cf8dd78fef28addf618ca6902dddf9,0,0,0,0,0,
20200329,WA,7715,68097,,,,,,,,,A,3/29/2020 00:00,2020-03-29T00:00:00Z,03/28 20:00,237,,2020-03-29T00:00:00Z,,,,5900,53,318,1515,75812,75812,1833,75812,17,0,c15c3936883e37992599a4ad1fc982bb3dcbc815,0,0,0,0,0,
20200328,WA,7397,66582,,,,,,,,,A,3/28/2020 00:00,2020-03-28T00:00:00Z,03/27 20:00,220,,2020-03-28T00:00:00Z,,,,5659,53,321,2280,73979,73979,2601,73979,21,0,2142a6a8184335f6c8a6096021fe6800a562c682,0,0,0,0,0,
20200327,WA,7076,64302,,,,,,,,,A,3/27/2020 00:00,2020-03-27T00:00:00Z,03/26 20:00,199,,2020-03-27T00:00:00Z,,,,5375,53,376,3984,71378,71378,4360,71378,16,0,091ac9f03362ecfb35ffb3870cca190691095995,0,0,0,0,0,
20200326,WA,6700,60318,,,,,,,,,A,3/26/2020 00:00,2020-03-26T00:00:00Z,03/25 20:00,183,,2020-03-26T00:00:00Z,,,,4918,53,371,4100,67018,67018,4471,67018,24,0,6a693242bd735dd28f94f26fd3f1355294b23212,0,0,0,0,0,
20200325,WA,6329,56218,,,,,,,,,A,3/25/2020 00:00,2020-03-25T00:00:00Z,03/24 20:00,159,,2020-03-25T00:00:00Z,,,,4485,53,406,4601,62547,62547,5007,62547,13,0,4fc4d7732f69835d51e4cecd5166e4a0b3ca5866,0,0,0,0,0,
20200324,WA,5923,51617,,,,,,,,,A,3/24/2020 00:00,2020-03-24T00:00:00Z,03/23 20:00,146,,2020-03-24T00:00:00Z,,,,4047,53,355,4872,57540,57540,5227,57540,9,0,66d5302cbd15f36e2e0dc85173aac938f8037de2,0,0,0,0,0,
20200323,WA,5568,46745,,,,,,,,,A,3/23/2020 00:00,2020-03-23T00:00:00Z,03/22 20:00,137,,2020-03-23T00:00:00Z,,,,3612,53,447,4856,52313,52313,5303,52313,11,0,673b0eebe1a761a4102d78478d8f6dd5aec34b8a,0,0,0,0,0,
20200322,WA,5121,41889,,,,,,,,,,3/22/2020 00:00,2020-03-22T00:00:00Z,03/21 20:00,126,,2020-03-22T00:00:00Z,,,,3149,53,284,1604,47010,47010,1888,47010,15,0,7754544ab50416f8c26d3d3928a58491703fc2de,0,0,0,0,0,
20200321,WA,4837,40285,,,,,,,,,,3/21/2020 00:00,2020-03-21T00:00:00Z,03/20 20:00,111,,2020-03-21T00:00:00Z,,,,2965,53,286,2056,45122,45122,2342,45122,7,0,21335bff56031d94176d33c9b20e251247f555c5,0,0,0,0,0,
20200320,WA,4551,38229,,,,,,,,,,3/20/2020 00:00,2020-03-20T00:00:00Z,03/19 20:00,104,,2020-03-20T00:00:00Z,,,,2771,53,405,3656,42780,42780,4061,42780,12,0,7a39bdbe36c8df0bd8df1304e13de2e37bdd6127,0,0,0,0,0,
20200319,WA,4146,34573,,,,,,,,,,3/19/2020 00:00,2020-03-19T00:00:00Z,03/18 20:00,92,,2020-03-19T00:00:00Z,,,,2467,53,336,4214,38719,38719,4550,38719,10,0,3d6abbeedd192976e14dcb9e9cbf841027edb40f,0,0,0,0,0,
20200318,WA,3810,30359,,,,,,,,,,3/18/2020 00:00,2020-03-18T00:00:00Z,03/17 20:00,82,,2020-03-18T00:00:00Z,,,,2134,53,378,4362,34169,34169,4740,34169,4,0,bed220fc6e4b04e3d8dede12a6b6e8736060515e,0,0,0,0,0,
20200317,WA,3432,25997,,,,,,,,,,3/17/2020 00:00,2020-03-17T00:00:00Z,03/16 20:00,78,,2020-03-17T00:00:00Z,,,,1845,53,325,4313,29429,29429,4638,29429,9,0,013782de28c700d47cc4385bd38caf596b185b9a,0,0,0,0,0,
20200316,WA,3107,21684,,,,,,,,,,3/16/2020 00:00,2020-03-16T00:00:00Z,03/15 20:00,69,,2020-03-16T00:00:00Z,,,,1581,53,369,4526,24791,24791,4895,24791,12,0,d763fab08774300fe9a6dbca97cc66dae42c9c7e,0,0,0,0,0,
20200315,WA,2738,17158,,,,,,,,,,3/15/2020 00:00,2020-03-15T00:00:00Z,03/14 20:00,57,,2020-03-15T00:00:00Z,,,,1281,53,254,1435,19896,19896,1689,19896,6,0,2660af34afc4c7f8a061280c38039a894f24789c,0,0,0,0,0,
20200314,WA,2484,15723,,,,,,,,,,3/14/2020 00:00,2020-03-14T00:00:00Z,03/13 20:00,51,,2020-03-14T00:00:00Z,,,,1174,53,266,2063,18207,18207,2329,18207,4,0,abf6c455b112f6afc88dc1b274447676bb4d174a,0,0,0,0,0,
20200313,WA,2218,13660,,,,,,,,,,3/13/2020 00:00,2020-03-13T00:00:00Z,03/12 20:00,47,,2020-03-13T00:00:00Z,,,,1018,53,297,3937,15878,15878,4234,15878,3,0,0543ebffd42a53ceb6bc3ba17054b59f20f20412,0,0,0,0,0,
20200312,WA,1921,9723,,,,,,,,,,3/12/2020 00:00,2020-03-12T00:00:00Z,03/11 20:00,44,,2020-03-12T00:00:00Z,,,,801,53,256,3508,11644,11644,3764,11644,4,0,61d9f398dbe899d27d4caad9e6588be9651957bf,0,0,0,0,0,
20200311,WA,1665,6215,,,,,,,,,,3/11/2020 00:00,2020-03-11T00:00:00Z,03/10 20:00,40,,2020-03-11T00:00:00Z,,,,622,53,212,2055,7880,7880,2267,7880,3,0,f95f39b9cf5b6857a8edf14d110adaada7e04971,0,0,0,0,0,
20200310,WA,1453,4160,,,,,,,,,,3/10/2020 00:00,2020-03-10T00:00:00Z,03/09 20:00,37,,2020-03-10T00:00:00Z,,,,488,53,216,1568,5613,5613,1784,5613,2,0,05bfd2e52d846bde898dc3f4c648ffa67aaf6705,0,0,0,0,0,
20200309,WA,1237,2592,,,,,,,,,,3/9/2020 00:00,2020-03-09T00:00:00Z,03/08 20:00,35,,2020-03-09T00:00:00Z,,,,378,53,172,852,3829,3829,1024,3829,4,0,e6b399168df6fa43a17642e9a23bf71a0d823740,0,0,0,0,0,
20200308,WA,1065,1740,60,,,,,,,,,3/8/2020 00:00,2020-03-08T00:00:00Z,03/07 19:00,31,,2020-03-08T00:00:00Z,,,,317,53,153,370,2865,2805,523,2805,4,0,db9af349f420a0c320c6cc9349871310c0785d8a,0,0,0,0,0,
20200307,WA,912,1370,66,,,,,,,,,3/7/2020 00:00,2020-03-07T00:00:00Z,03/06 19:00,27,,2020-03-07T00:00:00Z,,,,256,53,99,304,2348,2282,403,2282,1,0,d7d8dd2a8855dab5327f58a9da890bee7765a6d1,0,0,0,0,0,
20200306,WA,813,1066,,,,,,,,,,3/6/2020 00:00,2020-03-06T00:00:00Z,03/05 19:00,26,,2020-03-06T00:00:00Z,,,,218,53,82,394,1879,1879,476,1879,6,0,06e0faccec0324acd9a3d705675295277a66bb96,0,0,0,0,0,
20200305,WA,731,672,,,,,,,,,,3/5/2020 00:00,2020-03-05T00:00:00Z,03/04 19:00,20,,2020-03-05T00:00:00Z,,,,179,53,105,255,1403,1403,360,1403,4,0,1f8bcc849acc8b3b757e9edc558bc858ece468b1,0,0,0,0,0,
20200304,WA,626,417,,,,,,,,,,3/4/2020 00:00,2020-03-04T00:00:00Z,03/03 19:00,16,,2020-03-04T00:00:00Z,,,,128,53,92,153,1043,1043,245,1043,2,0,54a0b6fc6d76beccecc296181fbb1f63f266c726,0,0,0,0,0,
20200303,WA,534,264,,,,,,,,,,3/3/2020 00:00,2020-03-03T00:00:00Z,03/02 19:00,14,,2020-03-03T00:00:00Z,,,,90,53,84,141,798,798,225,798,3,0,d3c3dbf4e86bfa7fd0fd1ffdd9315c5116582ba3,0,0,0,0,0,
20200302,WA,450,123,,,,,,,,,,3/2/2020 00:00,2020-03-02T00:00:00Z,03/01 19:00,11,,2020-03-02T00:00:00Z,,,,65,53,73,111,573,573,184,573,3,0,607fb7cac2017b6092c4ad713733083112471ada,0,0,0,0,0,
20200301,WA,377,12,,,,,,,,,,3/1/2020 00:00,2020-03-01T00:00:00Z,02/29 19:00,8,,2020-03-01T00:00:00Z,,,,34,53,78,-5,389,389,73,389,3,0,9fed7c6eb1c871273a485ae079de8b46fefca88d,0,0,0,0,0,
20200229,WA,299,17,,,,,,,,,,2/29/2020 00:00,2020-02-29T00:00:00Z,02/28 19:00,5,,2020-02-29T00:00:00Z,,,,18,53,24,17,316,316,41,316,1,0,2d2950095f15265c0d9ac16544709bc84f1c0b43,0,0,0,0,0,
20200228,WA,275,0,,,,,,,,,,,,,4,,,,,,,53,40,0,275,275,40,275,2,0,aff0fe7f947e120e546cf66737132da5e32ef8f8,0,0,0,0,0,
20200227,WA,235,0,,,,,,,,,,,,,2,,,,,,,53,27,0,235,235,27,235,0,0,5a281e3e7a27f313da5324531618c371f82cf70e,0,0,0,0,0,
20200226,WA,208,0,,,,,,,,,,,,,2,,,,,,,53,29,0,208,208,29,208,2,0,7d4485fd3f03d43b64cbfbc2fc6f9ecc2f6193d6,0,0,0,0,0,
20200225,WA,179,0,,,,,,,,,,,,,,,,,,,,53,31,0,179,179,31,179,0,0,1cc104085b9d5db6943364b4d6aa05c3416c1bdf,0,0,0,0,0,
20200224,WA,148,0,,,,,,,,,,,,,,,,,,,,53,26,0,148,148,26,148,0,0,71d9e8853dbf473a99491c052d64c44f7f3ee336,0,0,0,0,0,
20200223,WA,122,0,,,,,,,,,,,,,,,,,,,,53,16,0,122,122,16,122,0,0,d7b623a08a1dea330a4af457de3c57ae43d70061,0,0,0,0,0,
20200222,WA,106,0,,,,,,,,,,,,,,,,,,,,53,13,0,106,106,13,106,0,0,72f385ff1949c15b12c369cf3a8a19175c063d6c,0,0,0,0,0,
20200221,WA,93,0,,,,,,,,,,,,,,,,,,,,53,11,0,93,93,11,93,0,0,b9edbe33e5ba645a35760510064da90d283d676f,0,0,0,0,0,
20200220,WA,82,0,,,,,,,,,,,,,,,,,,,,53,13,0,82,82,13,82,0,0,c5962cc9a0056dfab11f4ada8cad9257d731a7f8,0,0,0,0,0,
20200219,WA,69,0,,,,,,,,,,,,,,,,,,,,53,10,0,69,69,10,69,0,0,c7aee115ca405c8fa747543a19d14ecf0e955a31,0,0,0,0,0,
20200218,WA,59,0,,,,,,,,,,,,,,,,,,,,53,9,0,59,59,9,59,0,0,14893f184697f3ce72fc1ab1eb2349cf76d7952c,0,0,0,0,0,
20200217,WA,50,0,,,,,,,,,,,,,,,,,,,,53,15,0,50,50,15,50,0,0,6cd8507ad9f46ea615d537d0ea1b3faa855ed1bf,0,0,0,0,0,
20200216,WA,35,0,,,,,,,,,,,,,,,,,,,,53,7,0,35,35,7,35,0,0,fdee8b7d9d98d5a207bfddc41100f04a19afc08e,0,0,0,0,0,
20200215,WA,28,0,,,,,,,,,,,,,,,,,,,,53,7,0,28,28,7,28,0,0,868e738ba4bfebd4cb6798831ac3dadb132bfa70,0,0,0,0,0,
20200214,WA,21,0,,,,,,,,,,,,,,,,,,,,53,3,0,21,21,3,21,0,0,fc01f94f84dbd68169a32a0fad935a45f9fe9faa,0,0,0,0,0,
20200213,WA,18,0,,,,,,,,,,,,,,,,,,,,53,0,0,18,18,0,18,0,0,4fe9c95af96452a6273eb8795dc8e49d735d0b14,0,0,0,0,0,
20200212,WA,18,0,,,,,,,,,,,,,,,,,,,,53,1,0,18,18,1,18,0,0,72b162543ca666f1ebf2543eca78c13b40016152,0,0,0,0,0,
20200211,WA,17,0,,,,,,,,,,,,,,,,,,,,53,1,0,17,17,1,17,0,0,a2787c512ce577491a2f7ae74c513311b264610b,0,0,0,0,0,
20200210,WA,16,0,,,,,,,,,,,,,,,,,,,,53,3,0,16,16,3,16,0,0,3dff4457447a02d609c8b9e7e9a2c2eb3f5f3e31,0,0,0,0,0,
20200209,WA,13,0,,,,,,,,,,,,,,,,,,,,53,0,0,13,13,0,13,0,0,fd8d6adde61bae6f77a53157e71def2b646b43a4,0,0,0,0,0,
20200208,WA,13,0,,,,,,,,,,,,,,,,,,,,53,1,0,13,13,1,13,0,0,ffd331a78c50236e934798487257c839e62eb9d1,0,0,0,0,0,
20200207,WA,12,0,,,,,,,,,,,,,,,,,,,,53,1,0,12,12,1,12,0,0,1203031339d3459c09859136a5f3b8d11dc9a9f2,0,0,0,0,0,
20200206,WA,11,0,,,,,,,,,,,,,,,,,,,,53,3,0,11,11,3,11,0,0,251d742a5c65b5b95990956f3ccc7fdbf05eff32,0,0,0,0,0,
20200205,WA,8,0,,,,,,,,,,,,,,,,,,,,53,0,0,8,8,0,8,0,0,a1c6479a5344ec8a5ba2cc3af36ec59b30ad129f,0,0,0,0,0,
20200204,WA,8,0,,,,,,,,,,,,,,,,,,,,53,1,0,8,8,1,8,0,0,a0d736bcb34e1444d23a399c5c31ac8bf5a58a4d,0,0,0,0,0,
20200203,WA,7,0,,,,,,,,,,,,,,,,,,,,53,1,0,7,7,1,7,0,0,c6fe59b4a6bbcb51e739021823621d19b55113cf,0,0,0,0,0,
20200202,WA,6,0,,,,,,,,,,,,,,,,,,,,53,2,0,6,6,2,6,0,0,da334b4206ac16ad2ed6af55d190206287e74371,0,0,0,0,0,
20200201,WA,4,0,,,,,,,,,,,,,,,,,,,,53,1,0,4,4,1,4,0,0,931ed07bd8324d1ffb59805121d68b798c4af66b,0,0,0,0,0,
20200131,WA,3,0,,,,,,,,,,,,,,,,,,,,53,0,0,3,3,0,3,0,0,76e385140e4142c4b150ff2a59f66d494bc708d0,0,0,0,0,0,
20200130,WA,3,0,,,,,,,,,,,,,,,,,,,,53,0,0,3,3,0,3,0,0,7dd8e4b72c2b026dd67d96a44e518b1288025e89,0,0,0,0,0,
20200129,WA,3,0,,,,,,,,,,,,,,,,,,,,53,1,0,3,3,1,3,0,0,4b74d52fa86061f576a968f987d78721a8c68a08,0,0,0,0,0,
20200128,WA,2,0,,,,,,,,,,,,,,,,,,,,53,0,0,2,2,0,2,0,0,b90a5591083e5f46a3d48c14e45d748a8291d7e2,0,0,0,0,0,
20200127,WA,2,0,,,,,,,,,,,,,,,,,,,,53,0,0,2,2,0,2,0,0,4b9d62683ed9a1f2f71d9a7f8d0771f93c256e5f,0,0,0,0,0,
20200126,WA,2,0,,,,,,,,,,,,,,,,,,,,53,0,0,2,2,0,2,0,0,760c3dc0f1be8778f30b6d200547f3b5ac745758,0,0,0,0,0,
20200125,WA,2,0,,,,,,,,,,,,,,,,,,,,53,0,0,2,2,0,2,0,0,8c8515283dd7f193d5ec506f4d6ef8334bc50770,0,0,0,0,0,
20200124,WA,2,0,,,,,,,,,,,,,,,,,,,,53,0,0,2,2,0,2,0,0,01659896e63df6a3a877a4c826167fe0e44cb8a8,0,0,0,0,0,
20200123,WA,2,0,,,,,,,,,,,,,,,,,,,,53,0,0,2,2,0,2,0,0,b8c2a13e67216abb871b61007e5a22ff3828a041,0,0,0,0,0,
20200122,WA,2,0,,,,,,,,,,,,,,,,,,,,53,0,0,2,2,0,2,0,0,301c9c7fcd3ba68317ad772d47547f0448d98531,0,0,0,0,0,
