date,state,positive,negative,pending,hospitalizedCurrently,hospitalizedCumulative,inIcuCurrently,inIcuCumulative,onVentilatorCurrently,onVentilatorCumulative,recovered,dataQualityGrade,lastUpdateEt,dateModified,checkTimeEt,death,hospitalized,dateChecked,totalTestsViral,positiveTestsViral,negativeTestsViral,positiveCasesViral,fips,positiveIncrease,negativeIncrease,total,totalTestResults,totalTestResultsIncrease,posNeg,deathIncrease,hospitalizedIncrease,hash,commercialScore,negativeRegularScore,negativeScore,positiveScore,score,grade
20200624,KS,12970,148735,,,1082,,348,,150,747,A,6/24/2020 10:00,2020-06-24T10:00:00Z,06/24 06:00,261,1082,2020-06-24T10:00:00Z,,,,12970,20,505,6187,161705,161705,6692,161705,2,26,4c94e48f983b55e1871425b47f05c73404d4ee4f,0,0,0,0,0,
20200623,KS,12465,142548,,,1056,,342,,149,722,A,6/22/2020 10:00,2020-06-22T10:00:00Z,06/22 06:00,259,1056,2020-06-22T10:00:00Z,,,,12465,20,0,0,155013,155013,0,155013,0,0,d69e301dd42a8b5051b1d392a27548b58f2e1a39,0,0,0,0,0,
20200622,KS,12465,142548,,,1056,,342,,149,722,A,6/22/2020 10:00,2020-06-22T10:00:00Z,06/22 06:00,259,1056,2020-06-22T10:00:00Z,,,,12465,20,406,6958,155013,155013,7364,155013,5,21,c45702493d737649ba35546e972aa1a9dafafe6b,0,0,0,0,0,
20200621,KS,12059,135590,,,1035,,338,,146,715,A,6/19/2020 10:00,2020-06-19T10:00:00Z,06/19 06:00,254,1035,2020-06-19T10:00:00Z,,,,12059,20,0,0,147649,147649,0,147649,0,0,c1db9b48bbf595a6428c639a025a9df70b7b3e8f,0,0,0,0,0,
20200620,KS,12059,135590,,,1035,,338,,146,715,A,6/19/2020 10:00,2020-06-19T10:00:00Z,06/19 06:00,254,1035,2020-06-19T10:00:00Z,,,,12059,20,0,0,147649,147649,0,147649,0,0,e44e547e3993a5bfbe30f56636f94d7a60ae01d2,0,0,0,0,0,
20200619,KS,12059,135590,,,1035,,338,,146,715,A,6/19/2020 10:00,2020-06-19T10:00:00Z,06/19 06:00,254,1035,2020-06-19T10:00:00Z,,,,12059,20,378,5147,147649,147649,5525,147649,7,24,7a8c8b0148ab58761a7ec10633d09d1092705630,0,0,0,0,0,
20200618,KS,11681,130443,,,1011,,333,,146,696,A,6/17/2020 10:00,2020-06-17T10:00:00Z,06/17 06:00,247,1011,2020-06-17T10:00:00Z,,,,11681,20,0,0,142124,142124,0,142124,0,0,1cb6266d2b80b88760836b04f2fa70e9e52717f8,0,0,0,0,0,
20200617,KS,11681,130443,,,1011,,333,,146,696,A,6/17/2020 10:00,2020-06-17T10:00:00Z,06/17 06:00,247,1011,2020-06-17T10:00:00Z,,,,11681,20,262,4900,142124,142124,5162,142124,2,23,98f7486a8fa948cfd3d96ef719c0fed0606caa4f,0,0,0,0,0,
20200616,KS,11419,125543,,,988,,327,,143,676,A,6/15/2020 13:30,2020-06-15T13:30:00Z,06/15 09:30,245,988,2020-06-15T13:30:00Z,,,,11419,20,0,0,136962,136962,0,136962,0,0,7da7fa04121522a8e116574cdafbc0b2e8ac7d6a,0,0,0,0,0,
20200615,KS,11419,125543,,,988,,327,,143,676,A,6/12/2020 13:30,2020-06-12T13:30:00Z,06/12 09:30,245,988,2020-06-12T13:30:00Z,,,,11419,20,372,7438,136962,136962,7810,136962,2,15,4857ece9b296807f843879d6713df2bbd87e6908,0,0,0,0,0,
20200614,KS,11047,118105,,,973,,324,,143,667,A,6/12/2020 13:30,2020-06-12T13:30:00Z,06/12 09:30,243,973,2020-06-12T13:30:00Z,,,,11047,20,0,0,129152,129152,0,129152,0,0,577e5a6b4970f81ef2263a662a9fbc98084353c3,0,0,0,0,0,
20200613,KS,11047,118105,,,973,,324,,143,667,A,6/12/2020 13:30,2020-06-12T13:30:00Z,06/12 09:30,243,973,2020-06-12T13:30:00Z,,,,11047,20,0,0,129152,129152,0,129152,0,0,6ef60d6a5e5a0171c5f9ac1c372f4ec03e941a31,0,0,0,0,0,
20200612,KS,11047,118105,,,973,,324,,143,667,A,6/12/2020 13:30,2020-06-12T13:30:00Z,06/12 09:30,243,973,2020-06-12T13:30:00Z,,,,11047,20,235,5175,129152,129152,5410,129152,3,19,7cf33ebc8063a091cc0149deaf88c02b90fd4b74,0,0,0,0,0,
20200611,KS,10812,112930,,,954,,316,,139,657,A,6/10/2020 10:00,2020-06-10T10:00:00Z,06/10 06:00,240,954,2020-06-10T10:00:00Z,,,,10812,20,0,0,123742,123742,0,123742,0,0,918b746c1c00f16e188cb37747ed05fcb6248e40,0,0,0,0,0,
20200610,KS,10812,112930,,,954,,316,,139,657,A,6/10/2020 10:00,2020-06-10T10:00:00Z,06/10 06:00,240,954,2020-06-10T10:00:00Z,,,,10812,20,162,4071,123742,123742,4233,123742,4,18,f308a04cf5d9d82427a82b981dc75c66228c3b19,0,0,0,0,0,
20200609,KS,10650,108859,,,936,,311,,136,625,A,6/8/2020 10:00,2020-06-08T10:00:00Z,06/08 06:00,236,936,2020-06-08T10:00:00Z,,,,10650,20,0,0,119509,119509,0,119509,0,0,1bc995eae1602aad3b9c169c1071d0a8e7857179,0,0,0,0,0,
20200608,KS,10650,108859,,,936,,311,,136,625,A,6/8/2020 10:00,2020-06-08T10:00:00Z,06/08 06:00,236,936,2020-06-08T10:00:00Z,,,,10650,20,257,5599,119509,119509,5856,119509,4,19,b1d13424cbc4549495d113ea74496fffb8716a0b,0,0,0,0,0,
20200607,KS,10393,103260,,,917,,306,,135,612,A,6/5/2020 10:00,2020-06-05T10:00:00Z,06/05 06:00,232,917,2020-06-05T10:00:00Z,,,,10205,20,0,0,113653,113653,0,113653,0,0,530747a09055ba1b992df4ac494255719b4daf2c,0,0,0,0,0,
20200606,KS,10393,103260,,,917,,306,,135,612,A,6/5/2020 10:00,2020-06-05T10:00:00Z,06/05 06:00,232,917,2020-06-05T10:00:00Z,,,,10205,20,0,0,113653,113653,0,113653,0,0,4b941fcc7ee9dd072f5be8147cb0fa27f2d3cf13,0,0,0,0,0,
20200605,KS,10393,103260,,,917,,306,,135,612,A,6/5/2020 10:00,2020-06-05T10:00:00Z,06/05 06:00,232,917,2020-06-05T10:00:00Z,,,,10205,20,223,5377,113653,113653,5600,113653,10,27,d3d21683073f00caede4b8ef79d78eb3475665f8,0,0,0,0,0,
20200604,KS,10170,97883,,,890,,302,,131,592,A,6/3/2020 10:00,2020-06-03T10:00:00Z,06/03 06:00,222,890,2020-06-03T10:00:00Z,,,,9987,20,0,0,108053,108053,0,108053,0,0,7c3e3f8784d85c09dcff282811122d73b57130e3,0,0,0,0,0,
20200603,KS,10170,97883,,,890,,302,,131,592,A,6/3/2020 10:00,2020-06-03T10:00:00Z,06/03 06:00,222,890,2020-06-03T10:00:00Z,,,,9987,20,159,4582,108053,108053,4741,108053,5,28,014fb9aa86065d1f5c56b66a3aa1c34ee4cd8a62,0,0,0,0,0,
20200602,KS,10011,93301,,,862,,290,,127,555,A,6/1/2020 10:00,2020-06-01T10:00:00Z,06/01 06:00,217,862,2020-06-01T10:00:00Z,,,,9838,20,0,8071,103312,103312,8071,103312,0,20,d23a7ca8f4b91f2497c3c6d1c310ed90aeff94ce,0,0,0,0,0,
20200601,KS,10011,85230,,,842,,284,,124,547,A,6/1/2020 10:00,2020-06-01T10:00:00Z,06/01 06:00,217,842,2020-06-01T10:00:00Z,,,,10011,20,292,0,95241,95241,292,95241,9,0,d245ddfaada04e55ec6c0a36370c5e68083c4409,0,0,0,0,0,
20200531,KS,9719,85230,,,842,,284,,124,547,A,5/29/2020 10:00,2020-05-29T10:00:00Z,05/29 06:00,208,842,2020-05-29T10:00:00Z,,,,9719,20,0,0,94949,94949,0,94949,0,0,d44c8bf78ea3352497ed7907e56fa54188ddb112,0,0,0,0,0,
20200530,KS,9719,85230,,,842,,284,,124,547,A,5/29/2020 10:00,2020-05-29T10:00:00Z,05/29 06:00,208,842,2020-05-29T10:00:00Z,,,,9719,20,0,0,94949,94949,0,94949,0,0,0e315f9b8cfa06bd03775d210aba8a369c8d7921,0,0,0,0,0,
20200529,KS,9719,85230,,,842,,284,,124,547,A,5/29/2020 10:00,2020-05-29T10:00:00Z,05/29 06:00,208,842,2020-05-29T10:00:00Z,,,,9719,20,382,10079,94949,94949,10461,94949,3,20,d6301d231c349c79e5c033ca4d01dc1e27a14217,0,0,0,0,0,
20200528,KS,9337,75151,,,822,,275,,122,534,A,5/27/2020 10:00,2020-05-27T10:00:00Z,05/27 06:00,205,822,2020-05-27T10:00:00Z,,,,9337,20,0,0,84488,84488,0,84488,0,0,86209a4cc1118bdbf512977d9c2cf30e4567a6c3,0,0,0,0,0,
20200527,KS,9337,75151,,,822,,275,,122,534,A,5/27/2020 10:00,2020-05-27T10:00:00Z,05/27 06:00,205,822,2020-05-27T10:00:00Z,,,,9337,20,119,2970,84488,84488,3089,84488,17,22,b168463480d71e40f4eeeb3588baef77be3ea414,0,0,0,0,0,
20200526,KS,9218,72181,,,800,,271,,120,493,A+,5/25/2020 10:00,2020-05-25T10:00:00Z,05/25 06:00,188,800,2020-05-25T10:00:00Z,,,,9218,20,0,0,81399,81399,0,81399,0,0,ab3878a4f59fd6c3da5e2abce2a711887c62dee2,0,0,0,0,0,
20200525,KS,9218,72181,,,800,,271,,120,493,A+,5/25/2020 10:00,2020-05-25T10:00:00Z,05/25 06:00,188,800,2020-05-25T10:00:00Z,,,,9218,20,260,4705,81399,81399,4965,81399,3,13,90983fb8382625839a9026ee2f170f12ffd731a2,0,0,0,0,0,
20200524,KS,8958,67476,,,787,,269,,120,485,A+,5/22/2020 10:00,2020-05-22T10:00:00Z,05/22 06:00,185,787,2020-05-22T10:00:00Z,,,,8958,20,0,0,76434,76434,0,76434,0,0,1bb30802e0d014c9d19057c4de38963af06a5536,0,0,0,0,0,
20200523,KS,8958,67476,,,787,,269,,120,485,A+,5/22/2020 10:00,2020-05-22T10:00:00Z,05/22 06:00,185,787,2020-05-22T10:00:00Z,,,,8958,20,0,0,76434,76434,0,76434,0,0,70368ffb1ce245ab8dff0f30d5e9dd36de828fbd,0,0,0,0,0,
20200522,KS,8958,67476,,,787,,269,,120,485,A+,5/22/2020 10:00,2020-05-22T10:00:00Z,05/22 06:00,185,787,2020-05-22T10:00:00Z,,,,8958,20,419,4812,76434,76434,5231,76434,7,27,b96d913e48da307b97e6d00325ca535d00f7b63a,0,0,0,0,0,
20200521,KS,8539,62664,,,760,,258,,116,473,A+,5/20/2020 10:00,2020-05-20T10:00:00Z,05/20 06:00,178,760,2020-05-20T10:00:00Z,,,,8539,20,0,0,71203,71203,0,71203,0,0,6349dd8e2af58bc512810a96be12068f1aabd2f2,0,0,0,0,0,
20200520,KS,8539,62664,,,760,,258,,116,473,A+,5/20/2020 10:00,2020-05-20T10:00:00Z,05/20 06:00,178,760,2020-05-20T10:00:00Z,,,,8539,20,199,4014,71203,71203,4213,71203,5,20,7cfec77514de473f9dc31c7e732183272b605f7d,0,0,0,0,0,
20200519,KS,8340,58650,,,740,,250,,115,465,A,5/18/2020 10:00,2020-05-18T10:00:00Z,05/18 06:00,173,740,2020-05-18T10:00:00Z,,,,8340,20,0,0,66990,66990,0,66990,0,0,0a81216e3e69ba5baa3a2149af77862ac78fa28a,0,0,0,0,0,
20200518,KS,8340,58650,,,740,,250,,115,465,A,5/18/2020 10:00,2020-05-18T10:00:00Z,05/18 06:00,173,740,2020-05-18T10:00:00Z,,,,8232,20,454,4944,66990,66990,5398,66990,1,16,868066a96ff0e40b53eb098e6605e9103ede22b8,0,0,0,0,0,
20200517,KS,7886,53706,,,724,,246,,112,443,A,5/15/2020 10:00,2020-05-15T10:00:00Z,05/15 06:00,172,724,2020-05-15T10:00:00Z,,,,,20,0,0,61592,61592,0,61592,0,0,944eb403a463f7855ec87ad0dfeba0e9c1424e65,0,0,0,0,0,
20200516,KS,7886,53706,,,724,,246,,112,443,A,5/15/2020 10:00,2020-05-15T10:00:00Z,05/15 06:00,172,724,2020-05-15T10:00:00Z,,,,,20,0,0,61592,61592,0,61592,0,0,7a932eac8c0535e4aa89d8070848857ef9f7ff3e,0,0,0,0,0,
20200515,KS,7886,53706,,,724,,246,,112,443,A,5/15/2020 10:00,2020-05-15T10:00:00Z,05/15 06:00,172,724,2020-05-15T10:00:00Z,,,,,20,418,3546,61592,61592,3964,61592,8,20,f819733c3d20c7a10eca192e3f2aca0992329cc9,0,0,0,0,0,
20200514,KS,7468,50160,,,704,,238,,108,422,A,5/13/2020 10:00,2020-05-13T10:00:00Z,05/13 06:00,164,704,2020-05-13T10:00:00Z,,,,,20,0,0,57628,57628,0,57628,0,0,43c2e24dc75cff03bdb48015674b4e001e57a62c,0,0,0,0,0,
20200513,KS,7468,50160,,,704,,238,,108,422,A,5/13/2020 10:00,2020-05-13T10:00:00Z,05/13 06:00,164,704,2020-05-13T10:00:00Z,,,,,20,352,3167,57628,57628,3519,57628,6,44,9a418b98aaed401fb515e38558c8f0cd69adad98,0,0,0,0,0,
20200512,KS,7116,46993,,,660,,233,,101,376,A,5/11/2020 10:00,2020-05-11T10:00:00Z,05/11 06:00,158,660,2020-05-11T10:00:00Z,,,,,20,0,0,54109,54109,0,54109,0,0,3ab0f606e6da93a87218a896e4cf4c3339cec276,0,0,0,0,0,
20200511,KS,7116,46993,,,660,,233,,101,376,A,5/11/2020 10:00,2020-05-11T10:00:00Z,05/11 06:00,158,660,2020-05-11T10:00:00Z,,,,,20,168,1436,54109,54109,1604,54109,1,3,966a9d4f0e86b262f0434f457ee9e551c0530924,0,0,0,0,0,
20200510,KS,6948,45557,,,657,,231,,101,371,A,5/10/2020 10:00,2020-05-10T10:00:00Z,05/10 06:00,157,657,2020-05-10T10:00:00Z,,,,,20,197,2375,52505,52505,2572,52505,0,22,6c91fd092ebdec789410d6b4c95036b6e8aef066,0,0,0,0,0,
20200509,KS,6751,43182,,,635,,229,,100,350,A,5/9/2020 10:00,2020-05-09T10:00:00Z,05/09 06:00,157,635,2020-05-09T10:00:00Z,,,,6144,20,250,1975,49933,49933,2225,49933,5,27,aa30bfc5944bc039eb89754c543cecf2b0adcc03,0,0,0,0,0,
20200508,KS,6501,41207,,,608,,223,,99,332,A,5/8/2020 10:00,2020-05-08T10:00:00Z,05/08 06:00,152,608,2020-05-08T10:00:00Z,,,,6144,20,357,2529,47708,47708,2886,47708,5,21,4b2f1f8910eba3ebbdb8420de5439a6d380fab7b,0,0,0,0,0,
20200507,KS,6144,38678,,,587,,218,,97,323,A,5/7/2020 10:00,2020-05-07T10:00:00Z,05/07 06:00,147,587,2020-05-07T10:00:00Z,,,,6144,20,410,2298,44822,44822,2708,44822,3,16,4c620d92788bad1b67faa1426d2fb8c0630bb382,0,0,0,0,0,
20200506,KS,5734,36380,,,571,,213,,96,318,A,5/6/2020 10:00,2020-05-06T10:00:00Z,05/06 06:00,144,571,2020-05-06T10:00:00Z,,,,5734,20,276,1746,42114,42114,2022,42114,7,5,7e23added51f0d6b1e4555f3777c7514f12aca45,0,0,0,0,0,
20200505,KS,5458,34634,,,566,,212,,95,296,A,5/5/2020 10:00,2020-05-05T10:00:00Z,05/05 06:00,137,566,2020-05-05T10:00:00Z,,,,5458,20,213,1276,40092,40092,1489,40092,1,13,548136011c0456d4218d6759bc5ec32d88c8286c,0,0,0,0,0,
20200504,KS,5245,33358,,,553,,209,,95,291,A,5/3/2020 10:00,2020-05-03T10:00:00Z,05/03 06:00,136,553,2020-05-03T10:00:00Z,,,,5245,20,215,1610,38603,38603,1825,38603,2,6,6cb0075dfeb3b9b88786c81c081b5a080e001f18,0,0,0,0,0,
20200503,KS,5030,31748,,,547,,209,,95,286,A,5/3/2020 10:00,2020-05-03T10:00:00Z,05/03 06:00,134,547,2020-05-03T10:00:00Z,,,,5030,20,284,1552,36778,36778,1836,36778,3,6,d4e466866160b184573a0a3456b62c3fb251aa2a,0,0,0,0,0,
20200502,KS,4746,30196,,,541,,206,,95,286,A,5/2/2020 10:00,2020-05-02T10:00:00Z,05/02 06:00,131,541,2020-05-02T10:00:00Z,,,,4746,20,297,1611,34942,34942,1908,34942,1,7,845b3916f7e1dc9e2961c781d7744b7a003eb349,0,0,0,0,0,
20200501,KS,4449,28585,,,534,,206,,96,280,A,5/1/2020 10:00,2020-05-01T10:00:00Z,05/01 06:00,130,534,2020-05-01T10:00:00Z,,,,4449,20,211,1197,33034,33034,1408,33034,1,11,ccfd47e08d8ba0a6d387237be56759369f86d28c,0,0,0,0,0,
20200430,KS,4238,27388,,,523,,201,,93,272,A,4/30/2020 10:00,2020-04-30T10:00:00Z,04/30 06:00,129,523,2020-04-30T10:00:00Z,,,,4238,20,500,1668,31626,31626,2168,31626,4,8,d62f01c251defb1babc00c28b5e9a01078c454df,0,0,0,0,0,
20200429,KS,3738,25720,,,515,,198,,88,266,A,4/29/2020 10:00,2020-04-29T10:00:00Z,04/29 06:00,125,515,2020-04-29T10:00:00Z,,,,3738,20,247,1121,29458,29458,1368,29458,1,11,61b29bed0727eda070c00a0c72954091f34d3011,0,0,0,0,0,
20200428,KS,3491,24599,,,504,,,,,,C,4/28/2020 10:00,2020-04-28T10:00:00Z,04/28 06:00,124,504,2020-04-28T10:00:00Z,,,,,20,163,760,28090,28090,923,28090,4,8,ee03dfd9422a6181fb157680a94d2404f3ab9004,0,0,0,0,0,
20200427,KS,3328,23839,,,496,,,,,,C,4/26/2020 11:00,2020-04-26T11:00:00Z,04/26 07:00,120,496,2020-04-26T11:00:00Z,,,,,20,154,786,27167,27167,940,27167,2,11,6f5beb47a0010239a59980aa7ef605c2fe79291c,0,0,0,0,0,
20200426,KS,3174,23053,,,485,,,,,,C,4/26/2020 11:00,2020-04-26T11:00:00Z,04/26 07:00,118,485,2020-04-26T11:00:00Z,,,,,20,118,910,26227,26227,1028,26227,1,11,421e74c30fa2325f387e71c98fc5e9ab2b99340e,0,0,0,0,0,
20200425,KS,3056,22143,,,474,,,,,,C,4/25/2020 11:00,2020-04-25T11:00:00Z,04/25 07:00,117,474,2020-04-25T11:00:00Z,,,,,20,279,1332,25199,25199,1611,25199,6,17,685f2dcbcab1f38479aac77c7fa323af086bad54,0,0,0,0,0,
20200424,KS,2777,20811,,,457,,,,,,B,4/24/2020 10:00,2020-04-24T10:00:00Z,04/24 06:00,111,457,2020-04-24T10:00:00Z,,,,,20,295,1975,23588,23588,2270,23588,-1,15,0a109852c221fb13dfd89ec43bde721168a7493e,0,0,0,0,0,
20200423,KS,2482,18836,,,442,,,,,,B,4/23/2020 10:45,2020-04-23T10:45:00Z,04/23 06:45,112,442,2020-04-23T10:45:00Z,,,,,20,271,844,21318,21318,1115,21318,2,10,5c994a4ab7b4aa376a33115dea5384eea7aae693,0,0,0,0,0,
20200422,KS,2211,17992,,,432,,,,,,B,4/22/2020 12:00,2020-04-22T12:00:00Z,04/22 08:00,110,432,2020-04-22T12:00:00Z,,,,,20,186,916,20203,20203,1102,20203,3,13,a2f9f7e0310cc0f0e121ca2f2ba5fd8636171488,0,0,0,0,0,
20200421,KS,2025,17076,,,419,,,,,,B,4/21/2020 12:00,2020-04-21T12:00:00Z,04/21 08:00,107,419,2020-04-21T12:00:00Z,,,,,20,39,301,19101,19101,340,19101,7,14,584ef3f674b5b84060f261fe2c3a006cad1cf31c,0,0,0,0,0,
20200420,KS,1986,16775,,,405,,,,,,B,4/20/2020 12:00,2020-04-20T12:00:00Z,04/20 08:00,100,405,2020-04-20T12:00:00Z,,,,,20,137,494,18761,18761,631,18761,8,15,87af0eeeb9558c43ee7de8762b80d9b4250f5953,0,0,0,0,0,
20200419,KS,1849,16281,,,390,,,,,,B,4/19/2020 12:00,2020-04-19T12:00:00Z,04/19 08:00,92,390,2020-04-19T12:00:00Z,,,,,20,59,395,18130,18130,454,18130,6,7,dee0a03a10f5b2a0fa578e7a1802b33c9177e2f7,0,0,0,0,0,
20200418,KS,1790,15886,,,383,,,,,,B,4/18/2020 12:00,2020-04-18T12:00:00Z,04/18 08:00,86,383,2020-04-18T12:00:00Z,,,,,20,85,690,17676,17676,775,17676,2,8,7f67af5de86c85b2a67a034dcc0f50766279c85e,0,0,0,0,0,
20200417,KS,1705,15196,,,375,,,,,,B,4/17/2020 12:00,2020-04-17T12:00:00Z,04/17 08:00,84,375,2020-04-17T12:00:00Z,,,,,20,117,662,16901,16901,779,16901,4,16,fffb22edd8dc21cbb02d9a30d242077dae16731e,0,0,0,0,0,
20200416,KS,1588,14534,,,359,,,,,,B,4/16/2020 12:00,2020-04-16T12:00:00Z,04/16 08:00,80,359,2020-04-16T12:00:00Z,,,,,20,94,1360,16122,16122,1454,16122,4,17,c1db07280dc83418638d53df87755064d0489bab,0,0,0,0,0,
20200415,KS,1494,13174,,,342,,,,,,B,4/15/2020 11:30,2020-04-15T11:30:00Z,04/15 07:30,76,342,2020-04-15T11:30:00Z,,,,,20,68,453,14668,14668,521,14668,7,15,3752f927a778415555d2ecd9b96c6910d28edad0,0,0,0,0,0,
20200414,KS,1426,12721,,,327,,,,,,B,4/14/2020 12:00,2020-04-14T12:00:00Z,04/14 08:00,69,327,2020-04-14T12:00:00Z,,,,,20,50,233,14147,14147,283,14147,7,18,53afb8ba6e6ae49dc273b43146ac5507935add4b,0,0,0,0,0,
20200413,KS,1376,12488,,,309,,,,,,B,4/13/2020 11:30,2020-04-13T11:30:00Z,04/13 07:30,62,309,2020-04-13T11:30:00Z,,,,,20,39,572,13864,13864,611,13864,6,11,6e8ebe9c5c4152ab3c9397f8eadada2e959ef0b8,0,0,0,0,0,
20200412,KS,1337,11916,,,298,,,,,,B,4/12/2020 12:00,2020-04-12T12:00:00Z,04/12 08:00,56,298,2020-04-12T12:00:00Z,,,,,20,69,841,13253,13253,910,13253,1,5,38bb230e3c406bb9442332ccc411f8d22ea5e0df,0,0,0,0,0,
20200411,KS,1268,11075,,,293,,,,,,B,4/11/2020 11:00,2020-04-11T11:00:00Z,04/11 07:00,55,293,2020-04-11T11:00:00Z,,,,,20,102,827,12343,12343,929,12343,5,19,ad27eb0a8c5061dc6130a66a67c09f9253cef61e,0,0,0,0,0,
20200410,KS,1166,10248,,,274,,,,,,B,4/10/2020 09:30,2020-04-10T09:30:00Z,04/10 05:30,50,274,2020-04-10T09:30:00Z,,,,,20,60,579,11414,11414,639,11414,8,11,42e8e26a5939ac94bd58c95a3407ae205e1deeac,0,0,0,0,0,
20200409,KS,1106,9669,,,263,,,,,,B,4/9/2020 12:00,2020-04-09T12:00:00Z,04/09 08:00,42,263,2020-04-09T12:00:00Z,,,,,20,60,532,10775,10775,592,10775,4,40,3704cd9406394532f73f933b9aa11ec253bdf501,0,0,0,0,0,
20200408,KS,1046,9137,,,223,,,,,,B,4/7/2020 12:00,2020-04-07T12:00:00Z,04/07 08:00,38,223,2020-04-07T12:00:00Z,,,,,20,146,523,10183,10183,669,10183,11,0,5f7d69354b63731f49a87e705b409e8d22433173,0,0,0,0,0,
20200407,KS,900,8614,,,223,,,,,,B,4/7/2020 12:00,2020-04-07T12:00:00Z,04/07 08:00,27,223,2020-04-07T12:00:00Z,,,,,20,55,375,9514,9514,430,9514,2,25,8a056f165db62f1b6b46a855393b6e94d8e42970,0,0,0,0,0,
20200406,KS,845,8239,,,198,,,,,,B,4/6/2020 12:00,2020-04-06T12:00:00Z,04/06 08:00,25,198,2020-04-06T12:00:00Z,,,,,20,98,763,9084,9084,861,9084,3,15,518a901dbb5b766a3165006ec6dc8932322cd0b0,0,0,0,0,0,
20200405,KS,747,7476,,,183,,,,,,B,4/5/2020 12:00,2020-04-05T12:00:00Z,04/05 08:00,22,183,2020-04-05T12:00:00Z,,,,,20,49,596,8223,8223,645,8223,1,11,e8e697493351f88bd183f6694ea4bf3ab75ccadd,0,0,0,0,0,
20200404,KS,698,6880,,,172,,,,,,B,4/4/2020 12:00,2020-04-04T12:00:00Z,04/04 08:00,21,172,2020-04-04T12:00:00Z,,,,,20,78,426,7578,7578,504,7578,4,21,866f16fd4c0feb560665997bcb68de4253d234c1,0,0,0,0,0,
20200403,KS,620,6454,,,151,,,,,,B,4/3/2020 12:00,2020-04-03T12:00:00Z,04/03 08:00,17,151,2020-04-03T12:00:00Z,,,,,20,68,395,7074,7074,463,7074,4,13,b1913916da11cc55cc457c92b84dba1df3f48c03,0,0,0,0,0,
20200402,KS,552,6059,,,138,,,,,,B,4/2/2020 12:00,2020-04-02T12:00:00Z,04/02 08:00,13,138,2020-04-02T12:00:00Z,,,,,20,70,648,6611,6611,718,6611,3,24,81ecc84aaa2fba19ba7845f47c28548a61293d66,0,0,0,0,0,
20200401,KS,482,5411,,,114,,,,,,B,4/1/2020 11:00,2020-04-01T11:00:00Z,04/01 07:00,10,114,2020-04-01T11:00:00Z,,,,,20,54,415,5893,5893,469,5893,1,35,ffb49103a7c904f87b1583bd7725e7e10c2a410c,0,0,0,0,0,
20200331,KS,428,4996,,,79,,,,,,B,3/31/2020 11:00,2020-03-31T11:00:00Z,03/31 07:00,9,79,2020-03-31T11:00:00Z,,,,,20,60,442,5424,5424,502,5424,1,13,358de25c921f5a5c05f5a0d1f7c824cc4d4d27a4,0,0,0,0,0,
20200330,KS,368,4554,,,66,,,,,,B,3/30/2020 11:00,2020-03-30T11:00:00Z,03/30 07:00,8,66,2020-03-30T11:00:00Z,,,,,20,49,360,4922,4922,409,4922,2,11,ea55d7e201f848d90f792e63c5a64ffa2f8aabf4,0,0,0,0,0,
20200329,KS,319,4194,,,55,,,,,,B,3/29/2020 11:00,2020-03-29T11:00:00Z,03/29 07:00,6,55,2020-03-29T11:00:00Z,,,,,20,58,523,4513,4513,581,4513,1,28,9fc6f7e87b7aab6ee6d2c56fc48857a907d88876,0,0,0,0,0,
20200328,KS,261,3671,,,27,,,,,,B,3/27/2020 09:00,2020-03-27T09:00:00Z,03/27 05:00,5,27,2020-03-27T09:00:00Z,,,,,20,59,442,3932,3932,501,3932,1,0,536036fc97bdd32e5c5a7849ff3b79f2dc009e9a,0,0,0,0,0,
20200327,KS,202,3229,,,27,,,,,,B,3/27/2020 09:00,2020-03-27T09:00:00Z,03/27 05:00,4,27,2020-03-27T09:00:00Z,,,,,20,34,360,3431,3431,394,3431,1,27,3534b5fbbbf5111895ab99c4b2ff141e3b4ec878,0,0,0,0,0,
20200326,KS,168,2869,,,,,,,,,B,3/26/2020 12:00,2020-03-26T12:00:00Z,03/26 08:00,3,,2020-03-26T12:00:00Z,,,,,20,42,509,3037,3037,551,3037,0,0,1dcc3ecb78cde03d7b15436dd1599f0a1eb7c24b,0,0,0,0,0,
20200325,KS,126,2360,,,,,,,,,B,3/25/2020 12:00,2020-03-25T12:00:00Z,03/25 08:00,3,,2020-03-25T12:00:00Z,,,,,20,28,274,2486,2486,302,2486,1,0,37c344d05d086973aa487241a1a4ddf70129296b,0,0,0,0,0,
20200324,KS,98,2086,,,,,,,,,B,3/24/2020 12:00,2020-03-24T12:00:00Z,03/24 08:00,2,,2020-03-24T12:00:00Z,,,,,20,16,1669,2184,2184,1685,2184,0,0,a00f8c19f8b593bdf9dab3da9b6ca294cbd5cc5d,0,0,0,0,0,
20200323,KS,82,417,,,,,,,,,B,3/23/2020 11:00,2020-03-23T11:00:00Z,03/23 07:00,2,,2020-03-23T11:00:00Z,,,,,20,18,0,499,499,18,499,0,0,96c434e65818ce2ec03c926874b33a94b400a472,0,0,0,0,0,
20200322,KS,64,417,,,,,,,,,,3/21/2020 11:00,2020-03-21T11:00:00Z,03/21 07:00,2,,2020-03-21T11:00:00Z,,,,,20,9,0,481,481,9,481,0,0,37a9bad2a98643441280191d23b3a6adf050fd04,0,0,0,0,0,
20200321,KS,55,417,,,,,,,,,,3/21/2020 11:00,2020-03-21T11:00:00Z,03/21 07:00,2,,2020-03-21T11:00:00Z,,,,,20,11,0,472,472,11,472,1,0,65a73a64f0cf266a322db2f244b4259a5e4cbd07,0,0,0,0,0,
20200320,KS,44,417,,,,,,,,,,3/20/2020 11:00,2020-03-20T11:00:00Z,03/20 07:00,1,,2020-03-20T11:00:00Z,,,,,20,10,0,461,461,10,461,0,0,d71e59ca2f0dbf591cb7705c39fe41377b470cca,0,0,0,0,0,
20200319,KS,34,417,,,,,,,,,,3/19/2020 11:00,2020-03-19T11:00:00Z,03/19 07:00,1,,2020-03-19T11:00:00Z,,,,,20,18,0,451,451,18,451,0,0,6ff0f01e24ed8137c33e2ea7d9d2ae3b576293e9,0,0,0,0,0,
20200318,KS,16,417,,,,,,,,,,3/17/2020 15:30,2020-03-17T15:30:00Z,03/17 11:30,1,,2020-03-17T15:30:00Z,,,,,20,1,35,433,433,36,433,0,0,22b0cc1fe2f25372009bfc4be964875d12c83674,0,0,0,0,0,
20200317,KS,15,382,,,,,,,,,,3/17/2020 13:00,2020-03-17T13:00:00Z,03/17 09:00,1,,2020-03-17T13:00:00Z,,,,,20,4,216,397,397,220,397,0,0,c662120b88216708e51c78bf3564a85afde0c94f,0,0,0,0,0,
20200316,KS,11,166,,,,,,,,,,3/16/2020 16:17,2020-03-16T16:17:00Z,03/16 12:17,1,,2020-03-16T16:17:00Z,,,,,20,3,31,177,177,34,177,0,0,f5e8e8fcd79e99ad4b58852502facc44e8c20ac3,0,0,0,0,0,
20200315,KS,8,135,,,,,,,,,,3/14/2020 13:00,2020-03-14T13:00:00Z,03/14 09:00,1,,2020-03-14T13:00:00Z,,,,,20,2,42,143,143,44,143,0,0,ac55e84aef68f72862495e3a8544e93493301f11,0,0,0,0,0,
20200314,KS,6,93,,,,,,,,,,3/13/2020 11:00,2020-03-13T11:00:00Z,03/13 07:00,1,,2020-03-13T11:00:00Z,,,,,20,0,0,99,99,0,99,1,0,135135f1982b03ab363ccdeb467769ad65df1b40,0,0,0,0,0,
20200313,KS,6,93,,,,,,,,,,3/13/2020 11:00,2020-03-13T11:00:00Z,03/13 07:00,,,2020-03-13T11:00:00Z,,,,,20,-991,78,99,99,-913,99,0,0,c9bfaff7837df7ccdfec1bf1ef0031abfa7a2770,0,0,0,0,0,
20200312,KS,997,15,,,,,,,,,,3/12/2020 00:00,2020-03-12T00:00:00Z,03/11 20:00,,,2020-03-12T00:00:00Z,28,13,15,1353,20,996,-26,1012,1012,970,1012,0,0,5fef2280d1b1aa22f9751ff55725221924711c17,0,0,0,0,0,
20200311,KS,1,41,,,,,,,,,,,,,,,,,,,,20,0,24,42,42,24,42,0,0,8ecca436de3d1cf98b012681ad39deca8f08a9ca,0,0,0,0,0,
20200310,KS,1,17,21,,,,,,,,,,,,,,,,,,,20,0,6,39,18,6,18,0,0,507683c83efa2b95732149970604dbd9c463ee85,0,0,0,0,0,
20200309,KS,1,11,0,,,,,,,,,,,,,,,,,,,20,0,0,12,12,0,12,0,0,861ca46bf59eb44961252823762a2ab76f2e8e3f,0,0,0,0,0,
20200308,KS,1,11,0,,,,,,,,,,,,,,,,,,,20,1,0,12,12,1,12,0,0,bfddd4da7e867b72c0676fd90f166d058947e1e2,0,0,0,0,0,
20200307,KS,0,11,2,,,,,,,,,,,,,,,,,,,20,0,7,13,11,7,11,0,0,2580ef422f2ad47972e702c73f79b3fc7ac91341,0,0,0,0,0,
20200306,KS,0,4,0,,,,,,,,,,,,,,,,,,,20,0,0,4,4,0,4,0,0,87318388ea71de0e5def0594e7ad2756ad7cd736,0,0,0,0,0,
