date,state,fips,positive,positiveIncrease,negative,negativeIncrease,pending,total,totalTestResults,totalTestResultsIncrease,posNeg,hospitalizedCurrently,hospitalizedCumulative,inIcuCurrently,inIcuCumulative,onVentilatorCurrently,onVentilatorCumulative,recovered,dataQualityGrade,lastUpdateEt,death,deathIncrease,hospitalized,hospitalizedIncrease,dateChecked,hash
20200520,VT,50,944,0,24114,0,,25058,25058,0,25058,15,,,,,,824,B,5/20/2020 00:00,54,0,,0,2020-05-20T20:00:00Z,39155ef5c7638c50a1a168ab01609d2a8fc03b22
20200519,VT,50,944,0,24114,567,,25058,25058,567,25058,24,,,,,,820,B,5/19/2020 00:00,54,0,,0,2020-05-19T20:00:00Z,a286e3cbc1ba0bf593e7636a12b94c9ecf8d48d4
20200518,VT,50,944,4,23547,573,,24491,24491,577,24491,22,,,,,,815,B,5/18/2020 00:00,54,0,,0,2020-05-18T20:00:00Z,802c8318c66d77868799ec2de3caa394516cc176
20200517,VT,50,940,0,22974,777,,23914,23914,777,23914,14,,,,,,810,B,5/17/2020 00:00,54,1,,0,2020-05-17T20:00:00Z,e63cab67d659aea7b2b3e551852a68a769ce036b
20200516,VT,50,940,8,22197,960,,23137,23137,968,23137,20,,,,,,804,B,5/16/2020 00:00,53,0,,0,2020-05-16T20:00:00Z,a1b5ad1e4a55303673fc4908654fd95b72edac34
20200515,VT,50,932,1,21237,740,,22169,22169,741,22169,17,,,,,,796,B,5/15/2020 00:00,53,0,,0,2020-05-15T20:00:00Z,95bbae158409fbd22e13360491fce9cd8410469a
20200514,VT,50,931,1,20497,789,,21428,21428,790,21428,18,,,,,,792,B,5/14/2020 00:00,53,0,,0,2020-05-14T20:00:00Z,918765811ee79aa6e6b0e89af656a4e383937d7e
20200513,VT,50,930,1,19708,601,,20638,20638,602,20638,17,,,,,,789,B,5/13/2020 00:00,53,0,,0,2020-05-13T20:00:00Z,3da1df923b39782749adc52a8d0d6fd3f4578dbd
20200512,VT,50,929,2,19107,310,,20036,20036,312,20036,18,,,,,,787,B,5/12/2020 00:00,53,0,,0,2020-05-12T20:00:00Z,ffab4eec43d33827403dfd11b8a3bf0664b9c745
20200511,VT,50,927,1,18797,630,,19724,19724,631,19724,14,,,,,,785,B,5/11/2020 00:00,53,0,,0,2020-05-11T20:00:00Z,72b0a8f076cb48291fcf0e2e99b07302cc660948
20200510,VT,50,926,0,18167,477,,19093,19093,477,19093,21,,,,,,777,B,5/10/2020 00:00,53,0,,0,2020-05-10T20:00:00Z,9fc224803cf6d92b754ade2d196d3840ab27993d
20200509,VT,50,926,8,17690,468,,18616,18616,476,18616,21,,,,,,744,B,5/9/2020 00:00,53,0,,0,2020-05-09T20:00:00Z,5be69835f80d5a1857dcbbfa2cdfbcefa6c285dd
20200508,VT,50,918,2,17222,532,,18140,18140,534,18140,15,,,,,,737,B,5/8/2020 00:00,53,0,,0,2020-05-08T20:00:00Z,df7fcad03eee344cf40a7ed2bd4f59f8223ed707
20200507,VT,50,916,2,16690,409,,17606,17606,411,17606,14,,2,,0,,718,B,5/7/2020 00:00,53,1,,0,2020-05-07T20:00:00Z,43bf18d19088161b41f2d134f12e0bf804230d32
20200506,VT,50,914,5,16281,216,,17195,17195,221,17195,26,,2,,0,,706,B,5/6/2020 00:00,52,0,,0,2020-05-06T20:00:00Z,becbb35f35cf34a702bad3e5241e632713067b24
20200505,VT,50,909,3,16065,176,,16974,16974,179,16974,33,,2,,0,,,B,5/5/2020 00:00,52,0,,0,2020-05-05T20:00:00Z,ba96bf08714a1400530244db29adae51fca00014
20200504,VT,50,906,5,15889,319,,16795,16795,324,16795,15,,,,,,,C,5/4/2020 00:00,52,0,,0,2020-05-04T20:00:00Z,15542719016e79162271162b904bcce206bd5268
20200503,VT,50,901,5,15570,338,,16471,16471,343,16471,19,,,,,,,C,5/3/2020 00:00,52,1,,0,2020-05-03T20:00:00Z,d0ce8edbee7802e507deacedbf82f134ffe9ae7e
20200502,VT,50,896,11,15232,302,,16128,16128,313,16128,11,,,,,,,C,5/2/2020 00:00,51,1,,0,2020-05-02T20:00:00Z,89c5fab571ae23035e95d2c22457733a56df42f3
20200501,VT,50,885,6,14930,573,,15815,15815,579,15815,19,,,,,,,C,5/1/2020 00:00,50,1,,0,2020-05-01T20:00:00Z,3f06b8d8ed15b5320ee84f10975a8b15e56aa1d6
20200430,VT,50,879,13,14357,202,,15236,15236,215,15236,23,,,,,,,C,4/30/2020 00:00,49,2,,0,2020-04-30T20:00:00Z,0f9a11765a741d9eb805c18c9f871501719a28d1
20200429,VT,50,866,4,14155,208,,15021,15021,212,15021,26,,,,,,,C,4/29/2020 00:00,47,0,,0,2020-04-29T20:00:00Z,a843a2802777cde60c17bc81b12c2ea8879591db
20200428,VT,50,862,0,13947,128,,14809,14809,128,14809,29,,,,,,,C,4/28/2020 00:00,47,0,,0,2020-04-28T20:00:00Z,c9afb0db00bc1636ad197ef45495c6472ddb2701
20200427,VT,50,862,7,13819,301,,14681,14681,308,14681,33,,,,,,,C,4/27/2020 00:00,47,1,,0,2020-04-27T20:00:00Z,1e0a7721fd1380373b4983a68ee3c487be55ecca
20200426,VT,50,855,3,13518,248,,14373,14373,251,14373,34,,,,,,,C,4/26/2020 00:00,46,0,,0,2020-04-26T20:00:00Z,c7822c8141eef5e10006318989c19b65a21e36e1
20200425,VT,50,852,9,13270,462,,14122,14122,471,14122,37,,,,,,,C,4/25/2020 00:00,46,2,,0,2020-04-25T20:00:00Z,df2e9d21068deb22c8e476b10f97abca6c3f5e80
20200424,VT,50,843,9,12808,388,,13651,13651,397,13651,32,,,,,,,A,4/24/2020 00:00,44,1,,0,2020-04-24T20:00:00Z,75fd4e0806e4b3c3d713c21f39f04e722e590640
20200423,VT,50,834,3,12420,323,,13254,13254,326,13254,44,,,,,,,A,4/23/2020 00:00,43,3,,0,2020-04-23T20:00:00Z,83052217513696e0e9914e4bfc070642811c1fa2
20200422,VT,50,831,3,12097,330,,12928,12928,333,12928,37,,,,,,,A,4/22/2020 00:00,40,0,,0,2020-04-22T20:00:00Z,4475ad8757e68bd3808b7f69b8febafa72f6ab38
20200421,VT,50,828,8,11767,96,,12595,12595,104,12595,41,,,,,,,A,4/21/2020 00:00,40,2,,0,2020-04-21T20:00:00Z,70915f08383459853458a0bfc6cb1160e479115e
20200420,VT,50,820,3,11671,221,,12491,12491,224,12491,49,,,,,,15,A,4/20/2020 00:00,38,0,,0,2020-04-20T20:00:00Z,cc8bbb62ccffcbd691acb43d181ebd15fbb7eac3
20200419,VT,50,817,4,11450,238,,12267,12267,242,12267,53,,,,,,15,A,4/19/2020 00:00,38,0,,0,2020-04-19T20:00:00Z,6a9f7013fd6c2bca377cb01742f403e988603f2c
20200418,VT,50,813,11,11212,399,,12025,12025,410,12025,56,,,,,,15,A,4/18/2020 00:00,38,3,,0,2020-04-18T20:00:00Z,af538415d8f3528b27a36b14e3fa206467de5f39
20200417,VT,50,802,10,10813,554,,11615,11615,564,11615,32,,,,,,15,A,4/17/2020 00:00,35,0,,0,2020-04-17T20:00:00Z,7092c406ec0eb2ce510e4bf9bb4874344e299727
20200416,VT,50,792,13,10259,346,,11051,11051,359,11051,58,,,,,,15,A,4/16/2020 00:00,35,5,,0,2020-04-16T20:00:00Z,11d2d1683e566a215fbe06fefd705e38ee09afc4
20200415,VT,50,779,9,9913,422,,10692,10692,431,10692,63,,,,,,15,A,4/15/2020 00:00,30,1,,0,2020-04-15T20:00:00Z,aac8107f2168844c80ec12af031840af3ae9998f
20200414,VT,50,770,9,9491,216,,10261,10261,225,10261,64,,,,,,15,A,4/14/2020 00:00,29,1,,0,2020-04-14T20:00:00Z,e9a47f5c8a25da4db9ede8a780a8aa2ed7e27327
20200413,VT,50,761,7,9275,551,,10036,10036,558,10036,33,,,,,,15,A,4/13/2020 00:00,28,1,,0,2020-04-13T20:00:00Z,f8d65b33aecd178fa0263d04157af0eb8bfd5525
20200412,VT,50,754,21,8724,661,,9478,9478,682,9478,34,,,,,,15,A,4/12/2020 00:00,27,2,,0,2020-04-12T20:00:00Z,620fcfb16cb4aa5cff3b82cf8a002d045e77cf09
20200411,VT,50,733,20,8063,561,,8796,8796,581,8796,77,,,,,,15,A,4/11/2020 00:00,25,1,,0,2020-04-11T20:00:00Z,93f91603e68aa5c6f1062a2679a00903949bf17a
20200410,VT,50,713,33,7502,284,,8215,8215,317,8215,32,,,,,,15,A,4/10/2020 00:00,24,1,,0,2020-04-10T20:00:00Z,cebb0d3ada4cff7bb16feb92809d2e68e93a4168
20200409,VT,50,680,49,7218,217,,7898,7898,266,7898,33,,,,,,15,A,4/9/2020 00:00,23,0,,0,2020-04-09T20:00:00Z,5e5f86887f32762868049b62346da844e8fcbc68
20200408,VT,50,631,23,7001,356,,7632,7632,379,7632,35,50,,,,,15,A,4/8/2020 00:00,23,0,50,5,2020-04-08T20:00:00Z,4eaaf1390b7d65f7466f0af89825dbf9aff071ed
20200407,VT,50,608,33,6645,484,,7253,7253,517,7253,29,45,,,,,15,A,4/7/2020 00:00,23,0,45,0,2020-04-07T20:00:00Z,8c457514a0f27928f8eb701e7fff5d23dba1ebc2
20200406,VT,50,575,32,6161,331,,6736,6736,363,6736,28,45,,,,,15,A,4/6/2020 00:00,23,1,45,0,2020-04-06T20:00:00Z,db7e66b3ebc5812157481d409c101b8b3fa56258
20200405,VT,50,543,31,5830,588,,6373,6373,619,6373,29,45,,,,,15,A,4/5/2020 00:00,22,2,45,0,2020-04-05T20:00:00Z,3df71c6add5b64ec2dc3b0402e360e6a37427e1a
20200404,VT,50,512,52,5242,377,,5754,5754,429,5754,29,45,,,,,15,A,4/4/2020 00:00,20,3,45,0,2020-04-04T20:00:00Z,910645c1f2f64f499ab808c9b643e560aaf5bde1
20200403,VT,50,460,70,4865,481,,5325,5325,551,5325,29,45,,,,,15,A,4/3/2020 00:00,17,0,45,0,2020-04-03T20:00:00Z,3ffd4146e5467fbbd4f49155dcdb215e124a6dfc
20200402,VT,50,390,31,4384,222,,4774,4774,253,4774,29,45,,,,,15,A,4/2/2020 00:00,17,1,45,0,2020-04-02T20:00:00Z,63648c532d08ba7d4c6f9bfbcf5abb7e2680a7a7
20200401,VT,50,359,39,4162,213,,4521,4521,252,4521,30,45,,,,,15,A,4/1/2020 00:00,16,3,45,9,2020-04-01T20:00:00Z,caf3cd38b52c780e271d702d88fcdee5530936df
20200331,VT,50,320,27,3949,231,,4269,4269,258,4269,21,36,,,,,15,A,3/31/2020 00:00,13,1,36,18,2020-03-31T20:00:00Z,e29443941d5e0ab5a86a4825047589446c062062
20200330,VT,50,293,37,3718,235,,4011,4011,272,4011,,18,,,,,,A,3/30/2020 00:00,12,0,18,0,2020-03-30T20:00:00Z,49056d923a4de3084e6c3203ab6e21ddf446fe7a
20200329,VT,50,256,22,3483,291,,3739,3739,313,3739,,18,,,,,,A,3/29/2020 00:00,12,0,18,0,2020-03-29T20:00:00Z,61d0b4e90afe5d9df69d707d504c0480570cdecc
20200328,VT,50,234,21,3192,324,,3426,3426,345,3426,,18,,,,,,A,3/28/2020 00:00,12,2,18,0,2020-03-28T20:00:00Z,fce25dd8c7e3eb6d0f1cc80adc7f8fbd5f2415a8
20200327,VT,50,213,28,2868,124,,3081,3081,152,3081,,18,,,,,,A,3/27/2020 00:00,10,1,18,18,2020-03-27T20:00:00Z,0648b126ad519879f2f6450c66d66ff77070826a
20200326,VT,50,185,25,2744,934,,2929,2929,959,2929,,,,,,,,A,3/26/2020 00:00,9,1,,0,2020-03-26T20:00:00Z,44dd18529b946b986b5c6a692f95c1d780b9b902
20200325,VT,50,160,35,1810,241,,1970,1970,276,1970,,,,,,,,A,3/25/2020 00:00,8,1,,0,2020-03-25T20:00:00Z,50237e05e5ce6268b3f3e596fe2e7f4be93c1e1a
20200324,VT,50,125,28,1569,145,,1694,1694,173,1694,,,,,,,,A,3/24/2020 00:00,7,2,,0,2020-03-24T20:00:00Z,82305dba7632586a60e87d419ec0ea8a2764575c
20200323,VT,50,97,21,1424,220,,1521,1521,241,1521,,,,,,,,A,3/23/2020 00:00,5,3,,0,2020-03-23T20:00:00Z,92dccc93f91f0856261820263118cec941893aa6
20200322,VT,50,76,24,1204,124,,1280,1280,148,1280,,,,,,,,,3/22/2020 00:00,2,0,,0,2020-03-22T20:00:00Z,fd3b918584288ac6183f0f35c1188273000caa51
20200321,VT,50,52,8,1080,123,,1132,1132,131,1132,,,,,,,,,3/21/2020 00:00,2,0,,0,2020-03-21T20:00:00Z,743493047418722d5de7d6317fd394d2022c52e2
20200320,VT,50,44,16,957,193,,1001,1001,209,1001,,,,,,,,,3/20/2020 00:00,2,2,,0,2020-03-20T20:00:00Z,77af193b4c2361640dd3b0854d3d89d0a5008d56
20200319,VT,50,28,7,764,127,,792,792,134,792,,,,,,,,,3/19/2020 00:00,,0,,0,2020-03-19T20:00:00Z,fa7979e1685822d6381fb79d24d6731a21ee9b66
20200318,VT,50,21,2,637,56,,658,658,58,658,,,,,,,,,3/18/2020 00:00,,0,,0,2020-03-18T20:00:00Z,39d3f6557d011128734bf8e41a76940d3c47bab9
20200317,VT,50,19,2,581,94,,600,600,96,600,,,,,,,,,3/17/2020 00:00,,0,,0,2020-03-17T20:00:00Z,d051b2e22de7c0c05c23f6e60a5d61ade3b4f12a
20200316,VT,50,17,5,487,82,,504,504,87,504,,,,,,,,,3/16/2020 00:00,,0,,0,2020-03-16T20:00:00Z,bcea7777d09d3ff960e898243f8dfcb0cf16ed2b
20200315,VT,50,12,4,405,73,,417,417,77,417,,,,,,,,,3/15/2020 00:00,,0,,0,2020-03-15T20:00:00Z,5d8dc45b0864153a7ce35eb36f7d5f7a35b980dd
20200314,VT,50,8,3,332,109,,340,340,112,340,,,,,,,,,3/14/2020 00:00,,0,,0,2020-03-14T20:00:00Z,53932c48bcccf91133df589ced77cf09df5d453f
20200313,VT,50,5,3,223,87,,228,228,90,228,,,,,,,,,3/13/2020 00:00,,0,,0,2020-03-13T20:00:00Z,2cea667aa9a07cf9c66698d7d94091a64da55ec6
20200312,VT,50,2,0,136,45,,138,138,45,138,,,,,,,,,3/12/2020 00:00,,0,,0,2020-03-12T20:00:00Z,d4d623876c8b08c333c07e04322a01409caeb74f
20200311,VT,50,2,1,91,31,,93,93,32,93,,,,,,,,,3/11/2020 00:00,,0,,0,2020-03-11T20:00:00Z,033b01d547cbe3d65223d8c4b7a0bf38f5cedb07
20200310,VT,50,1,0,60,24,,61,61,24,61,,,,,,,,,3/10/2020 00:00,,0,,0,2020-03-10T20:00:00Z,d624540b7d7897310ac0113968c01c2b4a581932
20200309,VT,50,1,0,36,6,,37,37,6,37,,,,,,,,,3/9/2020 00:00,,0,,0,2020-03-09T20:00:00Z,0b9c0af2c101d7aae69e5fefbb65408a86517151
20200308,VT,50,1,0,30,5,,31,31,5,31,,,,,,,,,3/8/2020 00:00,,0,,0,2020-03-08T20:00:00Z,fa18a6a08893fff56edcac539c8d18f222d3635b
20200307,VT,50,1,1,25,25,,26,26,26,26,,,,,,,,,3/7/2020 00:00,,0,,0,2020-03-07T21:00:00Z,70939825c5309750d9d045c0ff02e06d829f3ce1
