date,state,fips,positive,positiveIncrease,negative,negativeIncrease,pending,total,totalTestResults,totalTestResultsIncrease,posNeg,hospitalizedCurrently,hospitalizedCumulative,inIcuCurrently,inIcuCumulative,onVentilatorCurrently,onVentilatorCumulative,recovered,dataQualityGrade,lastUpdateEt,death,deathIncrease,hospitalized,hospitalizedIncrease,dateChecked,hash
20200520,VT,50,944,0,24114,467,,25058,25058,467,25058,15,,,,,,824,B,5/20/2020 00:00,54,0,,0,2020-05-20T20:00:00Z,2d67dd085266a3b7a7ba5614c435a56cc9906727
20200519,VT,50,944,4,23647,762,,24591,24591,766,24591,24,,,,,,820,B,5/19/2020 00:00,54,0,,0,2020-05-19T20:00:00Z,ec9d1cae15b8a30b4d9b3bff5ac1494f01ed5faa
20200518,VT,50,940,0,22885,1543,,23825,23825,1543,23825,22,,,,,,815,B,5/18/2020 00:00,54,0,,0,2020-05-18T20:00:00Z,0fbfda55373d4ff2ff8e801ca8e4f518e9ec07ba
20200517,VT,50,940,6,21342,0,,22282,22282,6,22282,14,,,,,,810,B,5/17/2020 00:00,54,1,,0,2020-05-17T20:00:00Z,021e9b9f44c173c562ad3efedea301651dfc8952
20200516,VT,50,934,1,21342,-930,,22276,22276,-929,22276,20,,,,,,804,B,5/16/2020 00:00,53,0,,0,2020-05-16T20:00:00Z,93af0cb26d0907ed39de533dfa6206df09b70b01
20200515,VT,50,933,1,22272,699,,23205,23205,700,23205,17,,,,,,796,B,5/15/2020 00:00,53,0,,0,2020-05-15T20:00:00Z,7b4e20fe3b8707605eeaddf3c7015169fe4e86b3
20200514,VT,50,932,3,21573,826,,22505,22505,829,22505,18,,,,,,792,B,5/14/2020 00:00,53,0,,0,2020-05-14T20:00:00Z,6d27f02cdbac879d2124944e7c794005bac7c708
20200513,VT,50,929,2,20747,412,,21676,21676,414,21676,17,,,,,,789,B,5/13/2020 00:00,53,0,,0,2020-05-13T20:00:00Z,db9187a123881164ba525604e7042f3c6e5b8ffd
20200512,VT,50,927,1,20335,390,,21262,21262,391,21262,18,,,,,,787,B,5/12/2020 00:00,53,0,,0,2020-05-12T20:00:00Z,79deeffa461c242b02432c764e58cf647ec3c11b
20200511,VT,50,926,-1,19945,824,,20871,20871,823,20871,14,,,,,,785,B,5/11/2020 00:00,53,0,,0,2020-05-11T20:00:00Z,4adfe023563dfd5e045902060eed3963d63c9c19
20200510,VT,50,927,6,19121,515,,20048,20048,521,20048,21,,,,,,777,B,5/10/2020 00:00,53,0,,0,2020-05-10T20:00:00Z,7cb217bf74f929f7e5ec7949e51cea8e451c4ca0
20200509,VT,50,921,2,18606,517,,19527,19527,519,19527,21,,,,,,744,B,5/9/2020 00:00,53,0,,0,2020-05-09T20:00:00Z,c419c504a0c278c35c9b61870def13b07b2f4f7d
20200508,VT,50,919,3,18089,554,,19008,19008,557,19008,15,,,,,,737,B,5/7/2020 05:00,53,0,,0,2020-05-08T20:00:00Z,0e81069b194ce9b8fe5b2b325222ffc3f204a7f2
20200507,VT,50,916,8,17535,567,,18451,18451,575,18451,14,,2,,0,,718,B,5/6/2020 05:00,53,1,,0,2020-05-07T20:00:00Z,bedae4afd6fef7b9acb3487e33c62da930c1695d
20200506,VT,50,908,1,16968,357,,17876,17876,358,17876,26,,2,,0,,706,B,5/5/2020 05:00,52,0,,0,2020-05-06T20:00:00Z,24dd4a76678063d8bcf3a9f8b3e435b9aa364961
20200505,VT,50,907,5,16611,181,,17518,17518,186,17518,33,,2,,0,,,B,5/5/2020 10:26,52,0,,0,2020-05-05T20:00:00Z,ed60ee7200eaafc14b512cc0ee7e35d983ab53f8
20200504,VT,50,902,5,16430,373,,17332,17332,378,17332,15,,,,,,,C,5/4/2020 10:20,52,0,,0,2020-05-04T20:00:00Z,3adfc361c4826ae684636a8ffc30d779b0c05f3a
20200503,VT,50,897,11,16057,352,,16954,16954,363,16954,19,,,,,,,C,5/3/2020 10:44,52,1,,0,2020-05-03T20:00:00Z,645e651834b1b6b386afc83aa3a9f84ca3e02309
20200502,VT,50,886,7,15705,351,,16591,16591,358,16591,11,,,,,,,C,5/2/2020 10:18,51,1,,0,2020-05-02T20:00:00Z,b5f45eab7a9437476c243e71604cdf2456ab1609
20200501,VT,50,879,13,15354,568,,16233,16233,581,16233,19,,,,,,,C,5/1/2020 10:10,50,1,,0,2020-05-01T20:00:00Z,aaff276764d9d225262f0d124cdc424d09184a40
20200430,VT,50,866,4,14786,219,,15652,15652,223,15652,23,,,,,,,C,4/30/2020 10:34,49,2,,0,2020-04-30T20:00:00Z,bf66f4930cda9544f36dcbeace1e35223f1b62ae
20200429,VT,50,862,0,14567,214,,15429,15429,214,15429,26,,,,,,,C,4/29/2020 10:25,47,0,,0,2020-04-29T20:00:00Z,1c35019bfd09c6fb31dd946f96fb5729367585b8
20200428,VT,50,862,7,14353,135,,15215,15215,142,15215,29,,,,,,,C,4/28/2020 10:42,47,0,,0,2020-04-28T20:00:00Z,58fa7da09538fc810e92810f69057179ea5d5753
20200427,VT,50,855,4,14218,272,,15073,15073,276,15073,33,,,,,,,C,4/27/2020 00:00,47,1,,0,2020-04-27T20:00:00Z,886b87b410a269e531d6024ef8690aef9ad0f08e
20200426,VT,50,851,8,13946,107,,14797,14797,115,14797,34,,,,,,,C,4/26/2020 00:00,46,0,,0,2020-04-26T20:00:00Z,83a823b97ed52ed7221098949fe56a7f68872415
20200425,VT,50,843,16,13839,356,,14682,14682,372,14682,37,,,,,,,C,4/25/2020 10:00,46,2,,0,2020-04-25T20:00:00Z,fb4be51b6dc02b1b2c18ad8f8fcae5c759ce852c
20200424,VT,50,827,2,13483,456,,14310,14310,458,14310,32,,,,,,,A,4/24/2020 09:46,44,1,,0,2020-04-24T20:00:00Z,d3584809646fd5aebd8e6996ee5884597424eee9
20200423,VT,50,825,2,13027,388,,13852,13852,390,13852,44,,,,,,,A,4/23/2020 10:52,43,3,,0,2020-04-23T20:00:00Z,153a5d2a4f509d1f663af37632fa4ed6d899d2bf
20200422,VT,50,823,5,12639,346,,13462,13462,351,13462,37,,,,,,,A,4/22/2020 10:35,40,0,,0,2020-04-22T20:00:00Z,6c0419cd3c9f3eccce02fe2bae258647e2edd008
20200421,VT,50,818,2,12293,128,,13111,13111,130,13111,41,,,,,,,A,4/21/2020 10:39,40,2,,0,2020-04-21T20:00:00Z,c18c990ddfd3f796f55898e6807cb16248de812b
20200420,VT,50,816,4,12165,251,,12981,12981,255,12981,49,,,,,,15,A,4/20/2020 10:32,38,0,,0,2020-04-20T20:00:00Z,313fe4c0b6fdcc9b03ed513781f129f5697b3e76
20200419,VT,50,812,9,11914,151,,12726,12726,160,12726,53,,,,,,15,A,4/19/2020 10:12,38,0,,0,2020-04-19T20:00:00Z,936ab09798c80437c97f32d3ffc583b29f930535
20200418,VT,50,803,24,11763,426,,12566,12566,450,12566,56,,,,,,15,A,4/18/2020 09:50,38,3,,0,2020-04-18T20:00:00Z,7425046e9c94061d0f179c24dede5797b98fd3bd
20200417,VT,50,779,11,11337,598,,12116,12116,609,12116,32,,,,,,15,A,4/17/2020 10:05,35,0,,0,2020-04-17T20:00:00Z,f387159490dbf12f329e32518ec986ea91a355f3
20200416,VT,50,768,9,10739,417,,11507,11507,426,11507,58,,,,,,15,A,4/16/2020 09:20,35,5,,0,2020-04-16T20:00:00Z,5e70ed78bda7c00e07d1d47851a233fd5bbbfdd2
20200415,VT,50,759,7,10322,489,,11081,11081,496,11081,63,,,,,,15,A,4/15/2020 10:15,30,1,,0,2020-04-15T20:00:00Z,c428020743320d318aff77327d80da7c1493cec7
20200414,VT,50,752,4,9833,215,,10585,10585,219,10585,64,,,,,,15,A,4/13/2020 23:59,29,1,,0,2020-04-14T20:00:00Z,e49337ad4747733a6b0269eb0cc39abb01294559
20200413,VT,50,748,21,9618,504,,10366,10366,525,10366,33,,,,,,15,A,4/13/2020 09:05,28,1,,0,2020-04-13T20:00:00Z,67890c4f919439b309f876ec9c6945ff51d6819a
20200412,VT,50,727,16,9114,567,,9841,9841,583,9841,34,,,,,,15,A,4/12/2020 00:00,27,2,,0,2020-04-12T20:00:00Z,8e653dc32e6479fec846d949a8275f6798fd59cb
20200411,VT,50,711,32,8547,994,,9258,9258,1026,9258,77,,,,,,15,A,4/11/2020 00:00,25,1,,0,2020-04-11T20:00:00Z,48683ef32fd25e001353655642404f7cba04ce11
20200410,VT,50,679,51,7553,0,,8232,8232,51,8232,32,,,,,,15,A,4/10/2020 11:00,24,1,,0,2020-04-10T20:00:00Z,34be9dac9aed5ba11a9b54a37bf77034289d9761
20200409,VT,50,628,23,7553,409,,8181,8181,432,8181,33,,,,,,15,A,4/9/2020 09:30,23,0,,0,2020-04-09T20:00:00Z,8c3943492e7e2305f7f69f689cb2a6f279e1e6f4
20200408,VT,50,605,30,7144,590,,7749,7749,620,7749,35,50,,,,,15,A,4/8/2020 11:00,23,0,50,5,2020-04-08T20:00:00Z,06b946905f2814de9588a98047219200ac80a6c2
20200407,VT,50,575,32,6554,464,,7129,7129,496,7129,29,45,,,,,15,A,4/6/2020 23:59,23,0,45,0,2020-04-07T20:00:00Z,1590a9d3b626bffaf361895dd9a60e3158964cb1
20200406,VT,50,543,31,6090,20,,6633,6633,51,6633,28,45,,,,,15,A,4/6/2020 13:00,23,1,45,0,2020-04-06T20:00:00Z,c32f16e81f12685f62272438441d20350dfa8b6d
20200405,VT,50,512,51,6070,687,,6582,6582,738,6582,29,45,,,,,15,A,4/5/2020 13:00,22,2,45,0,2020-04-05T20:00:00Z,8354d17923d8af538c1116cbb2b5310a1f14d537
20200404,VT,50,461,72,5383,544,,5844,5844,616,5844,29,45,,,,,15,A,4/4/2020 01:00,20,3,45,0,2020-04-04T20:00:00Z,b52cadcc43e9c64bf9fc426614cab2482fbc70c1
20200403,VT,50,389,51,4839,128,,5228,5228,179,5228,29,45,,,,,15,A,4/3/2020 13:00,17,0,45,0,2020-04-03T20:00:00Z,3a45a9b35437980a09d9ffce7f8bffe31299d4fc
20200402,VT,50,338,17,4711,537,,5049,5049,554,5049,29,45,,,,,15,A,4/2/2020 13:00,17,1,45,0,2020-04-02T20:00:00Z,6634f77701510c09a9f9fba8c8a74f820ba15074
20200401,VT,50,321,28,4174,217,,4495,4495,245,4495,30,45,,,,,15,A,4/1/2020 13:00,16,3,45,9,2020-04-01T20:00:00Z,b3c55c13cb3d7975fd663bb203b9be35b2c57076
20200331,VT,50,293,37,3957,283,,4250,4250,320,4250,21,36,,,,,15,A,3/31/2020 13:00,13,1,36,18,2020-03-31T20:00:00Z,1e041148c705cbd9fb3198a491ab16f6724de286
20200330,VT,50,256,21,3674,208,,3930,3930,229,3930,,18,,,,,,A,3/30/2020 13:00,12,0,18,0,2020-03-30T20:00:00Z,8f6bd3a175c9b8e1a22ac7ab0a281b8dec22295a
20200329,VT,50,235,24,3466,1303,,3701,3701,1327,3701,,18,,,,,,A,3/29/2020 13:00,12,0,18,0,2020-03-29T20:00:00Z,b9567a48c7733df2be72a2c2ae16cf9d6a12e40a
20200328,VT,50,211,27,2163,86,,2374,2374,113,2374,,18,,,,,,A,3/28/2020 13:00,12,2,18,0,2020-03-28T20:00:00Z,2a82ba8031362931fdcfa93fdf1a84dfb3b0e6df
20200327,VT,50,184,26,2077,227,,2261,2261,253,2261,,18,,,,,,A,3/27/2020 13:00,10,1,18,18,2020-03-27T20:00:00Z,9f5d16c119c213f9747bafb1374a7e9ab385d5f9
20200326,VT,50,158,35,1850,261,,2008,2008,296,2008,,,,,,,,A,3/26/2020 13:00,9,1,,0,2020-03-26T20:00:00Z,616098b949a2ae30292d1def3de4037fdc2523d3
20200325,VT,50,123,28,1589,149,,1712,1712,177,1712,,,,,,,,A,3/25/2020 13:00,8,1,,0,2020-03-25T20:00:00Z,cfb6e973cf04fb9313e2280042f8d01ba7de951a
20200324,VT,50,95,20,1440,334,,1535,1535,354,1535,,,,,,,,A,3/24/2020 13:00,7,2,,0,2020-03-24T20:00:00Z,4dcee28e7588c7f81dd3cedf7faeb9c6da276636
20200323,VT,50,75,23,1106,0,,1181,1181,23,1181,,,,,,,,A,3/23/2020 13:00,5,3,,0,2020-03-23T20:00:00Z,521ea9da34c6d774ac93c3808c73797551bacf8c
20200322,VT,50,52,23,1106,327,,1158,1158,350,1158,,,,,,,,,3/22/2020 14:00,2,0,,0,2020-03-22T20:00:00Z,7e37a48717eeda121bec2df5ff350728bece737e
20200321,VT,50,29,0,779,0,,808,808,0,808,,,,,,,,,3/20/2020 14:00,2,0,,0,2020-03-21T20:00:00Z,e61ea2ef7b5a0db524791972488766b4f24291e4
20200320,VT,50,29,7,779,134,,808,808,141,808,,,,,,,,,3/20/2020 14:00,2,2,,0,2020-03-20T20:00:00Z,c5e9cd37e100a86a91a47e73848cb3975561e140
20200319,VT,50,22,3,645,53,,667,667,56,667,,,,,,,,,3/19/2020 14:00,,0,,0,2020-03-19T20:00:00Z,72d8d6cf3273f166c9f135e9a10a82b007d20c27
20200318,VT,50,19,9,592,97,,611,611,106,611,,,,,,,,,3/17/2020 14:00,,0,,0,2020-03-18T20:00:00Z,d77fafb60194295be331988c0cf1a3f5ac44e090
20200317,VT,50,10,2,495,74,,505,505,76,505,,,,,,,,,3/17/2020 13:00,,0,,0,2020-03-17T20:00:00Z,c3a8340d237463ccd2e75d59e9bfe9517c80c893
20200316,VT,50,8,4,421,73,,429,429,77,429,,,,,,,,,3/16/2020 15:25,,0,,0,2020-03-16T20:00:00Z,5bfdb479d860ea92a783b07c88cf4236cd83918a
20200315,VT,50,4,0,348,121,,352,352,121,352,,,,,,,,,3/15/2020 13:00,,0,,0,2020-03-15T20:00:00Z,efbcfacaba7767403f1f5f9e3a4fcaf2cb1d24e4
20200314,VT,50,4,2,227,85,,231,231,87,231,,,,,,,,,3/14/2020 13:00,,0,,0,2020-03-14T20:00:00Z,6887f4550d041b0ef41322b97f83f52639a85a2a
20200313,VT,50,2,0,142,45,,144,144,45,144,,,,,,,,,3/13/2020 13:00,,0,,0,2020-03-13T20:00:00Z,3ee02287d0462c16679e01b487295dfb90fc0839
20200312,VT,50,2,1,97,35,,99,99,36,99,,,,,,,,,3/11/2020 13:00,,0,,0,2020-03-12T20:00:00Z,4e6ec665874c8622a1bed51bfcddebd55e127109
20200311,VT,50,1,0,62,22,,63,63,22,63,,,,,,,,,,,0,,0,2020-03-11T20:00:00Z,1b56f0c4bdfc4324fe8d2871bfcb25671f4a8b80
20200310,VT,50,1,0,40,6,,41,41,6,41,,,,,,,,,,,0,,0,2020-03-10T20:00:00Z,bc4f8162d97761b8e7f284e121f82c410142543e
20200309,VT,50,1,0,34,6,,35,35,6,35,,,,,,,,,,,0,,0,2020-03-09T20:00:00Z,0f31acd89bf26fab221a14615487236b0500d6bd
20200308,VT,50,1,1,28,12,,29,29,13,29,,,,,,,,,,,0,,0,2020-03-08T20:00:00Z,e14ea4e5a6f511f313207ecb1ff0227979309631
20200307,VT,50,0,0,16,8,,16,16,8,16,,,,,,,,,,,0,,0,2020-03-07T21:00:00Z,a775be9d6eca6a120a7593e8646eef40426d76a8
20200306,VT,50,0,,8,,,8,8,,8,,,,,,,,,,,,,,2020-03-06T21:00:00Z,38b21755065620ca6284900f9c97187f4cb4b5d3
