date,state,fips,positive,positiveIncrease,negative,negativeIncrease,pending,total,totalTestResults,totalTestResultsIncrease,posNeg,hospitalizedCurrently,hospitalizedCumulative,inIcuCurrently,inIcuCumulative,onVentilatorCurrently,onVentilatorCumulative,recovered,dataQualityGrade,lastUpdateEt,death,deathIncrease,hospitalized,hospitalizedIncrease,dateChecked,hash
20200521,DE,10,8386,192,39156,1938,,47542,47542,2130,47542,220,,,,,,4130,B,5/20/2020 18:00,317,7,,0,2020-05-21T20:00:00Z,0815ab2eb18752c03e724e867fad6188bb489754
20200520,DE,10,8194,157,37218,1123,,45412,45412,1280,45412,220,,,,,,3965,B,5/19/2020 18:00,310,6,,0,2020-05-20T20:00:00Z,edf29e7c93ca2435d1d725f9a4bdcc8f6c18bc4b
20200519,DE,10,8037,168,36095,1506,,44132,44132,1674,44132,236,,,,,,3760,B,5/18/2020 18:00,304,7,,0,2020-05-19T20:00:00Z,171ce67232340f760a10fc358453d7c423eba63c
20200518,DE,10,7869,199,34589,1394,,42458,42458,1593,42458,240,,,,,,3545,B,5/17/2020 18:00,297,7,,0,2020-05-18T20:00:00Z,3f1fa5fa7bc7e63b3c3912cf036af925080446e0
20200517,DE,10,7670,123,33195,984,,40865,40865,1107,40865,229,,,,,,3478,B,5/17/2020 11:57,290,4,,0,2020-05-17T20:00:00Z,5b3030b782f07dcfb0efb8aef2339d4169ddb2fc
20200516,DE,10,7547,174,32211,1306,,39758,39758,1480,39758,250,,,,,,3367,B,5/15/2020 18:00,286,15,,0,2020-05-16T20:00:00Z,0423a25bcc47b8710f509a416e14696d9d964798
20200515,DE,10,7373,150,30905,1271,,38278,38278,1421,38278,269,,,,,,3210,B,5/14/2020 18:00,271,11,,0,2020-05-15T20:00:00Z,15465d5704b5a775235ab99989f1ba9f3682975e
20200514,DE,10,7223,271,29634,1833,,36857,36857,2104,36857,273,,,,,,3080,B,5/13/2020 18:00,260,13,,0,2020-05-14T20:00:00Z,38cd2bef8914658e6c00835dd47d9cf3909fcf3e
20200513,DE,10,6952,211,27801,1251,,34753,34753,1462,34753,282,,,,,,2942,B,5/12/2020 18:00,247,10,,0,2020-05-13T20:00:00Z,c2a862cb6a2990e57f4bb43510ed8a941bb8119d
20200512,DE,10,6741,176,26550,1187,,33291,33291,1363,33291,276,,,,,,2802,B,5/11/2020 18:00,237,12,,0,2020-05-12T20:00:00Z,f7c4ae2be76a9d99c5ee40803125b2d0815ff19e
20200511,DE,10,6565,118,25363,771,,31928,31928,889,31928,275,,,,,,2619,B,5/10/2020 18:00,225,1,,0,2020-05-11T20:00:00Z,b18fae176bb1b2793faca771fd2631dee10b077f
20200510,DE,10,6447,170,24592,1573,,31039,31039,1743,31039,285,,,,,,2537,B,5/10/2020 12:03,224,3,,0,2020-05-10T20:00:00Z,8e1807a003150b7bd9d11f4ea40bc9a380af371a
20200509,DE,10,6277,166,23019,866,,29296,29296,1032,29296,288,,,,,,2450,B,5/8/2020 18:00,221,8,,0,2020-05-09T20:00:00Z,f67632d508fe310f8fd613f9177a333b4870a20b
20200508,DE,10,6111,172,22153,766,,28264,28264,938,28264,289,,,,,,2288,B,5/7/2020 18:00,213,11,,0,2020-05-08T20:00:00Z,5d98ac8809439e370842b547c16e7930a6ca9f60
20200507,DE,10,5939,161,21387,697,,27326,27326,858,27326,285,,,,,,2110,B,5/6/2020 18:00,202,9,,0,2020-05-07T20:00:00Z,aab8c9cb26921af5cbeff346e34176fd75898095
20200506,DE,10,5778,407,20690,1381,,26468,26468,1788,26468,299,,,,,,2008,B,5/5/2020 18:00,193,6,,0,2020-05-06T20:00:00Z,15d53d3e4e709084c188f92ea5612c8a2124be9f
20200505,DE,10,5371,83,19309,487,,24680,24680,570,24680,284,,,,,,1847,B,5/4/2020 18:00,187,5,,0,2020-05-05T20:00:00Z,a9e050b2a5cc0029b6aaa2b994dc4b2c45fc3b35
20200504,DE,10,5288,80,18822,293,,24110,24110,373,24110,281,,,,,,1716,B,5/3/2020 18:00,182,5,,0,2020-05-04T20:00:00Z,2ce5c6ce5da1e13f5de61e702b530ba77669ffc9
20200503,DE,10,5208,170,18529,455,,23737,23737,625,23737,284,,,,,,1640,B,5/2/2020 18:00,177,9,,0,2020-05-03T20:00:00Z,3682836c6f8cabff972a1b9de651e8814d2e71de
20200502,DE,10,5038,120,18074,407,,23112,23112,527,23112,300,,,,,,1546,B,5/2/2020 09:10,168,9,,0,2020-05-02T20:00:00Z,0d92134312d795af1aefeb7c6d3e5e84ce1da6f1
20200501,DE,10,4918,184,17667,581,,22585,22585,765,22585,281,,,,,,1403,B,5/1/2020 13:15,159,7,,0,2020-05-01T20:00:00Z,a01f626b92bddc233343e065df57f31ad611e2f8
20200430,DE,10,4734,79,17086,203,,21820,21820,282,21820,296,,,,,,1275,B,4/30/2020 12:10,152,8,,0,2020-04-30T20:00:00Z,e9dd2e661c1844f15775218991b3e6a56e41e323
20200429,DE,10,4655,80,16883,278,,21538,21538,358,21538,326,,,,,,1173,B,4/28/2020 18:00,144,7,,0,2020-04-29T20:00:00Z,60c3b3ea1b13b4d490f73dcbef0119d5ef51cae7
20200428,DE,10,4575,413,16605,1151,,21180,21180,1564,21180,337,,,,,,1096,B,4/27/2020 18:00,137,12,,0,2020-04-28T20:00:00Z,3c409ca93a1356c8965eb9927565c6f3d6c19510
20200427,DE,10,4162,128,15454,239,,19616,19616,367,19616,325,,,,,,996,B,4/26/2020 18:00,125,5,,0,2020-04-27T20:00:00Z,7bbf4f491501b1d832ee3d7ffc8e8ed5b5f6596a
20200426,DE,10,4034,458,15215,1093,,19249,19249,1551,19249,317,,,,,,911,B,4/25/2020 18:00,120,8,,0,2020-04-26T20:00:00Z,3344ee5af0b7cf9b205a1eda2a45e6563781b322
20200425,DE,10,3576,134,14122,185,,17698,17698,319,17698,300,,,,,,809,B,4/24/2020 18:00,112,12,,0,2020-04-25T20:00:00Z,73e093b6bac65e326e47c9bb00e86c5acd2e5a3b
20200424,DE,10,3442,134,13937,333,,17379,17379,467,17379,277,,,,,,703,A,4/23/2020 18:00,100,8,,0,2020-04-24T20:00:00Z,b102855011edb1ee5113d03719b1df02bf551928
20200423,DE,10,3308,108,13604,251,,16912,16912,359,16912,290,,,,,,643,A,4/22/2020 18:00,92,3,,0,2020-04-23T20:00:00Z,fa30e61d9e29978321c88a429493c29523ea9add
20200422,DE,10,3200,269,13353,-372,,16553,16553,-103,16553,269,,,,,,599,A,4/21/2020 18:00,89,7,,0,2020-04-22T20:00:00Z,8bae7cdfc840999344d557ca03078ee2315928dd
20200421,DE,10,2931,186,13725,0,,16656,16656,186,16656,263,,,,,,565,A,4/20/2020 18:00,82,10,,0,2020-04-21T20:00:00Z,fed3580fd87eaa52aac5b92ad5b8b6352c93e8e5
20200420,DE,10,2745,207,13725,1469,,16470,16470,1676,16470,256,,,,,,495,A,4/20/2020 12:00,72,5,,0,2020-04-20T20:00:00Z,b24738b2c4ba2b0298b4f3ac6423a22bca5b820b
20200419,DE,10,2538,215,12256,562,,14794,14794,777,14794,249,,,,,,466,A,4/18/2020 17:00,67,6,,0,2020-04-19T20:00:00Z,35815fe24cf483c4c79bdb9de5ce82c0b33ebd42
20200418,DE,10,2323,0,11694,0,,14017,14017,0,14017,224,,,,,,423,A,4/17/2020 17:00,61,0,,0,2020-04-18T20:00:00Z,3e38a510274b7963a180c1d88644a392f5ca285c
20200417,DE,10,2323,248,11694,419,,14017,14017,667,14017,224,,,,,,423,A,4/17/2020 17:00,61,9,,0,2020-04-17T20:00:00Z,022780d7c8a2b37d0c97c51bdf864f2ff45cdc1d
20200416,DE,10,2075,61,11275,187,,13350,13350,248,13350,209,,,,,,378,A,4/16/2020 16:00,52,6,,0,2020-04-16T20:00:00Z,9b50fd828f782a927d8c448e81340f99c1935c0b
20200415,DE,10,2014,253,11088,545,,13102,13102,798,13102,208,,,,,,354,A,4/15/2020 16:15,46,5,,0,2020-04-15T20:00:00Z,12e9a82a5f4e85c666c850c2cbdcf6178bf2f614
20200414,DE,10,1761,136,10543,348,,12304,12304,484,12304,204,,,,,,277,A,4/14/2020 17:45,41,6,,0,2020-04-14T20:00:00Z,e27fd4d0e37cbcc0a4431027c64e05467c2882cb
20200413,DE,10,1625,146,10195,571,,11820,11820,717,11820,201,,,,,,213,A,4/13/2020 17:00,35,2,,0,2020-04-13T20:00:00Z,a0970451581e71fa8ee11cf737b498ee335063ec
20200412,DE,10,1479,0,9624,0,,11103,11103,0,11103,190,,,,,,191,A,4/11/2020 13:30,33,0,,0,2020-04-12T20:00:00Z,b52b80fea1e67edd661a405b86824f302d6a63ee
20200411,DE,10,1479,153,9624,-791,,11103,11103,-638,11103,190,,,,,,191,A,4/11/2020 13:30,33,10,,0,2020-04-11T20:00:00Z,e50e1a913148a98d82fafa8ef0afd5d1f6f341ef
20200410,DE,10,1326,119,10415,1732,,11741,11741,1851,11741,181,,,,,,177,A,4/10/2020 14:00,23,0,,0,2020-04-10T20:00:00Z,fb04ba303d11c4d076e8be4c5ca7b3e892cb4dd0
20200409,DE,10,1207,279,8683,1055,,9890,9890,1334,9890,201,,,,,,173,A,4/9/2020 17:00,23,7,,0,2020-04-09T20:00:00Z,6c4757f9e7b906f7515705d116fbf052cda83f73
20200408,DE,10,928,0,7628,0,,8556,8556,0,8556,147,,,,,,144,A,4/7/2020 16:30,16,0,,0,2020-04-08T20:00:00Z,d3596eb4d6d4b44d6e3e85e49a56737d1cad7413
20200407,DE,10,928,255,7628,1307,,8556,8556,1562,8556,147,,,,,,144,A,4/7/2020 16:30,16,2,,0,2020-04-07T20:00:00Z,ffa9ba7e80633d91e728a4cb7f6295e220120571
20200406,DE,10,673,0,6321,0,,6994,6994,0,6994,101,,,,,,71,A,4/5/2020 03:30,14,0,,0,2020-04-06T20:00:00Z,9dcacbaf95837b085201918fbaaea322d02572ac
20200405,DE,10,673,80,6321,447,,6994,6994,527,6994,101,,,,,,71,C,4/5/2020 12:30,14,0,,0,2020-04-05T20:00:00Z,578ad90ab8c0102be514927251b8cc51374460da
20200404,DE,10,593,143,5874,879,,6467,6467,1022,6467,95,,,,,,71,C,4/4/2020 13:45,14,0,,0,2020-04-04T20:00:00Z,ac0a94a75f8698bfd107e9600fb041a63589240f
20200403,DE,10,450,57,4995,429,,5445,5445,486,5445,63,,,,,,71,C,4/3/2020 00:00,14,2,,0,2020-04-03T20:00:00Z,fc00252618b1dee8abfc1fa7821ff788cab48807
20200402,DE,10,393,25,4566,551,,4959,4959,576,4959,56,,,,,,49,C,4/2/2020 16:45,12,1,,0,2020-04-02T20:00:00Z,d73d79c4d7ef0e297b5ec741913262adc66b9725
20200401,DE,10,368,49,4015,319,,4383,4383,368,4383,51,,,,,,49,C,4/1/2020 12:30,11,1,,0,2020-04-01T20:00:00Z,338b08803728a86ea99433d36808746b19837e02
20200331,DE,10,319,55,3696,1480,,4015,4015,1535,4015,57,,,,,,22,C,3/31/2020 16:00,10,4,,0,2020-03-31T20:00:00Z,952ec264eefac431eddd23438ccf01d8457ba18f
20200330,DE,10,264,32,2216,2180,,2480,2480,2212,2480,45,,,,,,9,C,3/30/2020 00:00,6,0,,0,2020-03-30T20:00:00Z,9912f9b456e3f1d8c5ee7bb050942bb3fceab0d6
20200329,DE,10,232,18,36,0,,268,268,18,268,33,,,,,,9,C,3/29/2020 00:00,6,3,,0,2020-03-29T20:00:00Z,11bb4ab4c2c3af59408a1bdc2b9e21474f87d02f
20200328,DE,10,214,51,36,0,,250,250,51,250,31,,,,,,9,C,3/28/2020 00:00,3,1,,0,2020-03-28T20:00:00Z,ca4aee4cd320f1771a90214a1f0320aff781c8f0
20200327,DE,10,163,33,36,0,,199,199,33,199,15,,,,,,9,C,3/27/2020 00:00,2,1,,0,2020-03-27T20:00:00Z,0e25f55a6754d09e1ee283de37a1c6025108a11e
20200326,DE,10,130,15,36,0,,166,166,15,166,13,,,,,,4,C,3/26/2020 00:00,1,1,,0,2020-03-26T20:00:00Z,7a5f0d7821acb62e5e4d857aec34dd984415059d
20200325,DE,10,115,24,36,0,,151,151,24,151,11,,,,,,,C,3/25/2020 12:00,0,0,,0,2020-03-25T20:00:00Z,bc2a7d31f7d3d584eed23fdefdc8f35c83caf6ae
20200324,DE,10,91,23,36,0,,127,127,23,127,,,,,,,,C,3/24/2020 10:45,0,0,,0,2020-03-24T20:00:00Z,9f342d2fd0c142effe90590ff4e87bd080c62519
20200323,DE,10,68,12,36,0,,104,104,12,104,,,,,,,,C,3/23/2020 11:15,0,0,,0,2020-03-23T20:00:00Z,deb3a3634e4147438763d33ee819175d2718c585
20200322,DE,10,56,11,36,0,,92,92,11,92,,,,,,,,,3/22/2020 16:15,0,0,,0,2020-03-22T20:00:00Z,b5aab0f8857cb6394007c9b3fb8f2f5acae54d5b
20200321,DE,10,45,7,36,0,,81,81,7,81,,,,,,,,,3/21/2020 15:15,0,0,,0,2020-03-21T20:00:00Z,cd2a48feef24bbbbfaf8dc426b0d9bb55b879fdd
20200320,DE,10,38,8,36,0,,74,74,8,74,,,,,,,,,3/20/2020 10:00,0,0,,0,2020-03-20T20:00:00Z,2ccf4da32b48c74c2a41ce4547a40bb943108377
20200319,DE,10,30,5,36,0,,66,66,5,66,,,,,,,,,3/19/2020 12:00,0,0,,0,2020-03-19T20:00:00Z,63d9447a697024f49fc77845eb14b2efa7456c68
20200318,DE,10,25,9,36,0,,61,61,9,61,,,,,,,,,3/18/2020 11:30,,0,,0,2020-03-18T20:00:00Z,437f52e2a758a6c7a64f53763528bf2a95589996
20200317,DE,10,16,8,36,0,,52,52,8,52,,,,,,,,,3/16/2020 11:40,,0,,0,2020-03-17T20:00:00Z,24614bc89b77ded138e71603850270cecdf0d28e
20200316,DE,10,8,2,36,0,32,76,44,2,44,,,,,,,,,3/16/2020 15:37,,0,,0,2020-03-16T20:00:00Z,3ad23004b2f15bad44e76d53459d940d712dc18e
20200315,DE,10,6,0,36,0,32,74,42,0,42,,,,,,,,,3/14/2020 13:00,,0,,0,2020-03-15T20:00:00Z,4ce6cbc21c7c0de6f0b21da01cf31f27961768b0
20200314,DE,10,6,2,36,6,32,74,42,8,42,,,,,,,,,3/14/2020 13:00,,0,,0,2020-03-14T20:00:00Z,67decb0ad80abd16a8aeed14d18ce2a94f87dceb
20200313,DE,10,4,0,30,7,10,44,34,7,34,,,,,,,,,3/12/2020 16:00,,0,,0,2020-03-13T20:00:00Z,09130e198d7b4a4492d66eefd9dc48558836e70a
20200312,DE,10,4,3,23,6,14,41,27,9,27,,,,,,,,,3/12/2020 11:30,,0,,0,2020-03-12T20:00:00Z,f4bc4ced6bea8bf94883025cbacc77d2743f6591
20200311,DE,10,1,1,17,0,2,20,18,1,18,,,,,,,,,,,0,,0,2020-03-11T20:00:00Z,66902dde3f2f2dacf74f53ede076a0eef583d308
20200310,DE,10,0,0,17,2,3,20,17,2,17,,,,,,,,,,,0,,0,2020-03-10T20:00:00Z,eb2be513c7d4124966e81f628a94656fa5aecd11
20200309,DE,10,0,0,15,5,3,18,15,5,15,,,,,,,,,,,0,,0,2020-03-09T20:00:00Z,f13c0b9f7afdc76443d814032fa54300a3769868
20200308,DE,10,0,0,10,0,0,10,10,0,10,,,,,,,,,,,0,,0,2020-03-08T20:00:00Z,537696f567a35f7320414bbb85d79588a702b813
20200307,DE,10,0,0,10,0,0,10,10,0,10,,,,,,,,,,,0,,0,2020-03-07T21:00:00Z,9fb2818264e70dc4f1ea2e6de1d11477bfad2e6f
20200306,DE,10,0,,10,,0,10,10,,10,,,,,,,,,,,,,,2020-03-06T21:00:00Z,6af4e9858752cb3807a949d643ebd2cd3493d891
